暴れる (abareru): to act violently; to rage; to struggle; to be riotous​
溢れる (afureru): to overflow; to brim over; to flood
愛着 (aichaku): attachment; love; covetous affection​
合間 (aima): interval; break; pause; spare moment​
曖昧 (aimai): vague; ambiguous; unclear​
愛らしい (airashii): pretty; charming; lovely; adorable
愛社 (aisha): devotion to one’s company​
相性 (aishou): affinity; compatibility​
相次いで (aitsuide): one after the other; successively​
愛用 (aiyou): favorite; habitually used​
味付け (ajitsuke): seasoning; flavor​
赤字 (akaji): (being in) the red; deficit; red letter; red writing​; corrections (by a teacher or proofreader) written in red​
飽き (aki): weariness; boredom; tedium; tiresomeness​
空き地 (akichi): vacant land; unoccupied ground; empty lot​
諦め (akirame): resignation; acceptance; consolation​
悪化 (akka): (suffer) deterioration; growing worse; aggravation; degeneration; corruption​
憧れ (akogare): yearning; longing; aspiration; adoration; admiration​
憧れる (akogareru): to long for; to yearn after; to admire; to be attracted by
悪影響 (akueikyou): bad influence; negative influence​
悪意 (akui): ill will; spite; evil intention; malice​; bad meaning​
悪条件 (akujouken): unfavorable conditions; unfavourable conditions​
雨水 (amamizu/usui): rain water
甘やかす (amayakasu): to pamper; to spoil​
案外 (angai): unexpectedly; surprisingly​; unexpected; unanticipated; unforeseen; surprising
安易 (an’i): easy; simple​; easygoing; lighthearted; simplistic; irresponsible; careless; quick (to do)​
安価 (anka): low-priced; cheap; inexpensive​
仰向け (aomuke): face up
荒い (arai): rough; wild; violent; rude; coarse; harsh; fierce; heavy (e.g. breathing)​; immoderate; extravagant; reckless​
洗い出す (araidasu): to reveal something by washing the surface​; to bring to light; to reveal by investigation​
予め (arakajime): beforehand; in advance; previously​
争う (arasou): to compete; to contest; to contend​; to quarrel; to argue; to dispute; to be at variance; to oppose​
改める (aratameru): to change; to alter; to revise; to replace; to reform; to correct; to mend; to improve​
荒れる (areru): to be stormy; to be rough​; to be ruined; to fall into ruin​; to be in a bad temper; to lose one’s temper​
焦り (aseri): impatience
焦る (aseru): to be in a hurry; to be impatient; to be flustered; to lose one’s presence of mind; to be surprised​
足を運ぶ (ashi o hakobu): to go; to come; to turn out (at a meeting, event, etc.); to show up; to make your way to​
圧勝 (asshou): complete victory​
宛 (ate): addressed to
当てはまる (atehamaru): to apply (a rule); to be applicable; to come under (a category); to fulfill; to hold true​
後回し (atomawashi): putting off; postponing​
後戻り (atomodori): going backward; turning back; backtracking; doubling back​; retrogression; relapse; returning to a bad state​
あっという間 (attoiuma): a blink of time
厚かましい (atsukamashii): impudent; shameless; brazen​
慌ただしい (awatadashii): busy; hurried; confused; flurried
怪しい (ayashii): suspicious; dubious; doubtful; dodgy; suspicious (referring to a potential amorous relation); dangerous (e.g. financial situation); ominous (e.g. weather); strange; shady; fishy​
歩み寄る (ayumiyoru): to compromise; to meet halfway​; to step up to; to walk up to; to approach​
歩む (ayumu): to walk; to go on foot​
鮮やか (azayaka): vivid; bright; brilliant; clear; fresh; vibrant​; skillful; brilliant; beautiful; fine; excellent​
倍増 (baizou): double
離れ (banare): (suffix) separation from; loss of interest in; independence of; distancing (of oneself) from; disillusionment with; alienation from (something)
ばっさり: with a single stroke; resolutely; drastically; completely​
別荘 (bessou): holiday house; vacation home; villa; prison; jail
美術 (bijutsu): art; fine arts​
敏感 (binkan): sensitive; alert; aware; susceptible​
びっしょり: wet through; drenched​
美容院 (biyouin): beauty parlor; beauty salon; hairdressing salon​
募金 (bokin): fund-raising; collection of funds​
牧場 (bokujou): farm (livestock); ranch (US); pasture land; meadow; grazing land​
膨大 (boudai): huge; vast; enormous; colossal; extensive; large​; swelling; expansion
防犯 (bouhan): prevention of crime​
防災 (bousai): prevention of damage resulting from a natural disaster; protection against disaster​
部員 (buin): staff; member (club, society, etc.)​
部下 (buka): subordinate person​
ぶかぶか: too large (clothing); baggy; loose-fitting
分別 (bunbetsu): separation (e.g. of rubbish when recycling); classification; discrimination; division; distinction​
分解 (bunkai): disassembly; dismantling; disaggregating; analysis; disintegrating; decomposing; degrading​
分割 (bunkatsu): partition; division; separation; segmenting; splitting​
文系 (bunkei): humanities, social sciences, and fine arts; liberal arts
文献 (bunken): literature; books (reference); document​
文面 (bunmen): content of a letter​
分配 (bunpai): division; splitting; sharing; distribution; dissemination; allocation​
分量 (bunryou): amount; quantity​
分担 (buntan): taking on one’s share (e.g. of work); dividing (work, expenses, etc.) between; apportionment; allotment; allocation; assignment​
物資 (busshi): goods; materials; commodities; resources; supplies
着々と (chakuchaku to): steadily
着実 (chakujitsu): steady; sound; solid; reliable; trustworthy​
縮める (chidjimeru): to shorten; to reduce; to condense; to shrink​; to make (one’s body) smaller; to draw in (one’s legs); to duck (one’s head)​
縮む (chidjimu): to shrink; to contract; to diminish (in size)​
近々 (chikadjika): soon; nearness; before long​
近づく (chikazuku): to approach; to draw near; to get close​; to get acquainted with; to get closer to; to get to know​
蓄積 (chikuseki): accumulation; accumulate; store​
散らかす (chirakasu): to scatter around; to leave untidy​
地帯 (chitai): area; zone; belt (of land)​
知的 (chiteki): intellectual
地点 (chiten): site; point on a map; spot​
地球温暖化 (chikyuuondanka): global warming​
直結 (chokketsu): direct connection; direct link​
直後 (chokugo): immediately following​
直立 (chokuritsu): standing upright; standing straight
直前 (chokuzen): just before​
長編 (chouhen): long (e.g. novel, film)​
長方形 (chouhoukei): rectangle; oblong​
長期間 (choukikan): long period (of time)​
彫刻 (choukoku): carving; engraving; sculpture​
彫刻家 (choukokuka): engraver; carver; sculptor​
長距離 (choukyori): long distance; long haul​
調味料 (choumiryou): seasoning; flavoring; flavouring; condiment​
調理 (chouri): cooking; food preparation​
調整 (chousei): adjustment; regulation; coordination; reconciliation; tuning; fixing; tailoring​
調節 (chousetsu): regulation; adjustment; control​
聴衆 (choushuu): audience; attendance; hearers​
注意点 (chuuiten): important point; point to make note of​
抽象 (chuushou): abstraction
中断 (chuudan): interruption; suspension; break​
注意深い (chuuibukai): careful
忠実 (chuujitsu): faithful; devoted; loyal; honest; true​
中旬 (chuujun): middle of a month; second third of a month; 11th to 20th day of a month​
中華 (chuuka): Chinese food
中継 (chuukei): relay; relay broadcasting
駐輪所 (chuurinjo): bicycle parking place​
抽選 (chuusen): lottery; raffle; drawing (of lots)​
大学院 (daigakuin): graduate school
大学祭 (daigakusai): university festival; rag day
台無し (dainashi): mess; spoiled; spoilt; (come to) nothing; ruin​
題名 (daimei): title
段取り (dandori): programme; program; plans; arrangements​
段階 (dankai): grade; level; stage; class; phase; steps; order; gradation​
団結 (danketsu): unity; union; solidarity; combination; teaming up​
だらし無い (darashinai): slovenly (appearance, work, etc.); sloppy; untidy; undisciplined; careless; loose; slack​; weak; feeble; weak-willed; gutless​
脱出 (dasshutsu): escape; break-out​; prolapse; proptosis​
妥当 (datou): valid; proper; right; appropriate; reasonable​
出来上がる (dekiagaru): to be completed; to be finished; to be ready (e.g. to serve or eat)​
電源 (dengen): source of electricity; electrical power​; power (button on TV, etc.)​
電気屋 (denkiya): electric appliance store​
電波 (denpa): radio wave; reception; signal
伝染 (densen): contagion; infection​
伝達 (dentatsu): transmission (e.g. news, chemical signals, electricity); communication; delivery; conveyance; transfer; relay; propagation; conduction​
でたらめに: nonsense; irresponsible remark; codswallop; hogwash; rubbish
土台 (dodai): foundation; base; basis​
独占 (dokusen): monopoly; monopolization; exclusivity​; keeping to oneself​
読者 (dokusha): reader
独身者 (dokushinsha): unmarried person; bachelor
道中 (douchuu): during the journey; on the way; while travelling​
動機 (douki): motive; incentive​
同居 (doukyo): coexistence; living together​
同年代 (dounendai): the same generation; coeval​
導入 (dounyuu): introduction; bringing in; leading in; installation​
動作 (dousa): action; movements; motions; bearing; behaviour; behavior; execution; actuation; operation; manners​
同等 (doutou): equality; equal; same rights; same rank; equivalence​
絵本 (ehon): picture book​
影響力 (eikyouryoku): influence; clout; leverage​
映像 (eizou): image (on a screen); picture (e.g. on a TV)​; video; film; footage​
駅前 (ekimae): in front of station
延長 (enchou): extension; elongation; prolongation; lengthening​
円形 (enkei): round shape; circle; circular form​
演じる (enjiru): to perform (a play); to play (a part); to act (a part); to commit (a blunder)​
円満 (enman): harmonious; peaceful; happy; amicable; smooth; free from trouble​
襟 (eri): collar; lapel; neckband; neck​; nape of the neck; scruff of the neck​
不安定 (fuantei): instability; insecurity; crankiness​
不調 (fuchou): bad condition; not to work out (i.e. a deal); disagreement; break-off; disorder; slump; out of form​
不動産 (fudousan): real estate​
不動産屋 (fudousan’ya): real estate agent; realtor​
不十分 (fujuubun): insufficient; inadequate; imperfect; shortage​
不快 (fukai): displeasure; discomfort; unpleasantness​; indisposition; ailment​
不可欠 (fukaketsu): indispensable; essential​
深まる (fukamaru): to deepen; to heighten; to intensify​
深める (fukameru): to deepen; to heighten; to intensify​
不完全 (fukanzen): imperfect; incomplete; faulty; defective​
不機嫌 (fukigen): pout; displeasure; ill humor; ill humour; sullenness
付近 (fukin): neighbourhood; neighborhood; vicinity; environs​
不規則 (fukisoku): irregularity; unsteadiness; disorderly​
副 (fuku): assistant; associate; vice-; sub-; deputy
含める (fukumeru): to include (in a group or scope)​; to include (a nuance); to put in (an implication)​
膨らます (fukuramasu): to swell; to expand; to inflate; to bulge​
膨らむ (fukuramu): to expand; to swell (out); to get big; to become inflated​
福祉 (fukushi): welfare; well-being; social welfare; social security; social service​
複数 (fukusuu): plural; multiple; several​
普及 (fukyuu): diffusion; spread; popularization; promulgation; familiarization​
不明 (fumei): unclear; obscure; indistinct; uncertain; ambiguous​; unknown; unidentified​
不明瞭 (fumeiryou): dimness; obscurity; indistinctness; unclear; unintelligible​
ふもと: foot (of a mountain or hill); bottom; base
ふらふら: unsteadily (e.g. on one’s feet); shakily; staggering; tottering; reeling; dizzily; giddily; wavering (in one’s mind); unsteadily; indecisively​
触れ合い (fureai): contact; connectedness; rapport; mutual touching​
触れ合う (fureau): to come into contact with; to touch (each other)
振り込み (furikomi): payment made via bank deposit transfer​
振り向く (furimuku): to turn one’s face; to turn around; to look over one’s shoulder​
不良品 (furyouhin): inferior goods; defective product; defective goods​
塞ぐ (fusagu): to stop up; to close up; to block (up); to plug up; to shut up; to cover (ears, eyes, etc.); to close (eyes, mouth)​; to stand in the way; to obstruct​; to occupy; to fill up; to take up​
不採用 (fusaiyou): rejection (of an application)​
負担 (futan): burden; load; responsibility​; bearing (a cost, responsibility, etc.); shouldering​
風 (fuu): appearance; air​
不愉快 (fuyukai): unpleasant; disagreeable; displeasing; uncomfortable; unhappy​
街 (gai): … street; … quarter; … district​
外観 (gaikan): outward appearance; exterior appearance; outward show; looks​
外見 (gaiken): outward appearance​
概要 (gaiyou): outline; summary; overview; abridgment; synopsis​
学費 (gakuhi): tuition; school expenses
学業 (gakugyou): studies; schoolwork; classwork​
学年 (gakunen): academic year; school year​
学歴 (gakureki): academic background​
学生課 (gakuseika): student affairs office​
願望 (ganbou): desire; wish; aspiration​
頑丈 (ganjou): solid; firm; stout; burly; strong; sturdy​
頑固 (ganko): stubborn; obstinate; pigheaded​
がらがら: with a clatter; with a rattle​
がっしり: firmly; solidly; sturdily; strongly; toughly
合宿 (gasshuku): lodging together; training camp; boarding house​
画用紙 (gayoushi): drawing paper
芸能 (geinou): public entertainment; performing arts​; accomplishments; attainments​
劇的 (gekiteki): dramatic; exciting; touching​; extreme
現代人 (gendaijin): modern person; people of today​
現時点 (genjiten): present point (i.e. in history); at the present time​
原稿 (genkou): manuscript; copy; draft; notes; contribution​
原理 (genri): principle; theory; fundamental truth​
原料 (genryou): raw materials​
原作 (gensaku): original work​
原産 (gensan): place of origin; habitat​
厳守 (genshu): strict observance; rigid adherence; scrupulous compliance​
原則 (gensoku): principle; general rule​
減速 (gensoku): deceleration
幻想 (gensou): fantasy; illusion; vision; dream​
限定 (gentei): limit; restriction​
現在地 (genzaichi): present location; current location; “you are here” (on map)​
議題 (gidai): topic of discussion; agenda​
疑問点 (gimonten): point of uncertainty; unclarified issue; doubt​
銀行員 (ginkouin): bank employee; bank staff member; bank clerk​
ぎりぎり: just barely; only just; at the very limit; at the last moment
儀式 (gishiki): ceremony; rite; ritual; service​
ぎっしり: tightly (packed); densely; closely; crammed​
ぎざぎざ: notches; serration; indentation; jaggies (stair-step artifacts in computer images)​
ごちゃごちゃ: messy; confused; chaotic; disorderly; mixed-up; jumbled up
強引 (gouin): overbearing; coercive; pushy; forcible; high-handed​
ぐったり: limply; wearily; listlessly; languidly; exhaustedly; unenergetically
後日 (gojitsu): in the future; another day; later​
娯楽 (goraku): pleasure; amusement​
合同 (goudou): combination; union; incorporation; amalgamation; fusion
愚痴 (guchi): idle complaint; grumble​
ぐんぐん: rapidly; vigorously; by leaps and bounds; steadily​
行事 (gyouji): event; function​
行列 (gyouretsu): line; queue; procession; parade​
幅広い (habahiroi): extensive; wide; broad​
蜂 (hachi): bee; wasp
蜂蜜 (hachimitsu): honey
鉢植え (hachiue): potted plant​
破片 (hahen): fragment; broken piece; splinter; chip; shard​
背景 (haikei): background; scenery; backdrop; setting; circumstance; context​; backing; support (from behind the scenes)​
廃止 (haishi): abolition; repeal​
墓参り (hakamairi): visit to a grave​
発揮 (hakki): show (of power, ability, etc.); exhibition; demonstration; display; manifestation​
泊 (haku): counter for nights of a stay​
白衣 (hakui): white robe; (doctor’s) white gown​
鼻水 (hanamizu): nasal mucus; dripping nose; snot​
話し合い (hanashiai): discussion; conference​
話し声 (hanashigoe): speaking voice; talking voice​
話し手 (hanashite): speaker
販売者 (hanbaisha): seller; vendor​
反映 (han’ei): reflection (light, image, situation, attitude, etc.); reflecting​; influence; application (e.g. of an update)​
半額 (hangaku): half the amount (of money); half price; half fare​
半減 (hangen): reduction by half; halving​
恥 (haji): shame; embarrassment; disgrace​
反感 (hankan): antipathy; antagonism; animosity; revulsion; ill feeling​
半日 (hannichi): half day
反発 (hanpatsu): opposition; rebellion; revolt; resistance; backlash; refusal​; rebounding; recoiling; repulsion​
張り切る (harikiru): to be in high spirits; to be full of vigor (vigour); to be enthusiastic; to be eager; to stretch to breaking point​
反論 (hanron): objection; refutation; rebuttal; counterargument​
半数 (hansuu): half the number
腹を立てる (hara o tateru): to take offense; to take offence; to get angry; to lose one’s temper
張り紙 (harigami): paper patch; paper backing; poster; sticker; label​​
挟む (hasamu): to hold between (e.g. one’s fingers, chopsticks); to grip (from both sides)​; to put between; to sandwich between; to insert; to interpose​; to insert (e.g. a break into proceedings); to interpose (e.g. an objection); to interject; to throw in (e.g. a joke)​
発散 (hassan): emission; emanation; radiation; diffusion; dispersion​; letting out (feelings); venting​
発想 (hassou): idea; conception; way of thinking
発送 (hassou): sending; forwarding; shipping​
働き手 (hatarakite): worker; breadwinner; supporter​; able person; able man; productive worker​
果たす (hatasu): to accomplish; to achieve; to carry out; to fulfill; to fulfil; to realize; to execute; to perform; to do​
発言 (hatsugen): statement; remark; observation; utterance; speech; proposal​
早口 (hayakuchi): fast-talking; rapid talking​
早まる (hayamaru): to be brought forward (e.g. by three hours); to be moved up; to be advanced​; to quicken; to speed up; to gather speed
流行り (hayari): fashion; fad; vogue; craze​
隔てる (hedateru): to separate (by distance, time, etc.); to isolate; to partition; to divide​; to interpose; to have between​; to alienate; to estrange​
平凡 (heibon): ordinary; common; commonplace; mediocre; unremarkable; undistinguished; uneventful​
平気 (heiki): coolness; calmness; composure; unconcern​
弊社 (heisha): our firm; our company (humble)
閉店 (heiten): closing up shop (for the day)​; stopping business; going out of business​
変換  (henkan): change; conversion; transformation​
変形 (henkei): transformation; variation; metamorphosis; modification; deformation; variety; deformity; monster​
返金 (henkin): repayment
返品 (henpin): returned goods; returning purchased goods​
返信 (henshin): reply
偏食 (henshoku): unbalanced diet​
編集 (henshuu): editing; compilation​
返送 (hensou): sending back; return to sender​
返答 (hentou): reply; answer​
非 (hi): (prefix) un-; non-; an-​
日当たり (hiatari): exposure to the sun; sunny place​
非凡 (hibon): extraordinary; uncommon; remarkable; unusual; rare; prodigious​
日々 (hibi): every day; daily; day after day; days (e.g. good old days)​
必着 (hicchaku): must arrive; must be received​
日帰り (higaeri): day trip​
日頃 (higoro): normally; habitually​
引き込む (hikikomu): to pull into; to draw in; to bring in​; to win over
引き止める (hikitomeru): to detain; to check; to restrain​
引き取る (hikitoru): to take into one’s possession; to receive; to accept; to collect; to claim​; to take (a person) into one’s care; to take custody of; to adopt​
引き続き (hikitsuzuki): continuously; continually; without a break​; next; then; after that​
引き渡す (hikiwatasu): to deliver; to extradite; to stretch across; to hand over​
引っかかる (hikkakaru): to be caught in; to be stuck in​; to get mixed up in (trouble); to get entangled in (a problem); to be involved with​
筆記 (hikki): (taking) notes; copying​; writing
非公式 (hikoushiki): informal; unofficial​
惹く (hiku): to draw (attention, sympathy, etc.); to attract (e.g. interest)​
卑怯 (hikyou): cowardice; meanness; unfairness​
非難 (hinan): criticism; blame; censure; attack; reproach​
避難 (hinan): taking refuge; finding shelter; evacuation; escape; seeking safe haven​
品質 (hinshitsu): (material) quality​
比例 (hirei): proportion
広場 (hiroba): plaza; (public) square; piazza; forum; open space
広々 (hirobiro): extensive; spacious​
広がり (hirogari): spread; span; expanse; extent​
広げる (hirogeru): to spread; to extend; to expand; to enlarge; to widen; to broaden; to unfold; to open; to unroll; to unwrap​
秘書 (hisho): (private) secretary​; treasured book; secret book​
潜む (hisomu): to lurk; to be hidden; to be concealed; to lie dormant; to be latent​
筆者 (hissha): writer; author​
ひそひそ: in a whisper; in a low voice; in undertones
密か (hisoka): secret; private; surreptitious​
秘する (hisuru): to keep secret; to conceal​
ひたすら: intently; single‐mindedly; devotedly; solely; earnestly; with all one’s heart
人前 (hitomae): presence of other people; (in) public; (in) front of others​
ひと昔 (hitomukashi): ages; long time; decade; the past ten years​
一人残らず (hitorinokorazu): everyone
必要不可欠 (hitsuyoufukaketsu): essential; indispensable; imperative; necessary; compelling, vital, critical​
冷やす (hiyasu): to cool (from room temperature); to chill; to refrigerate; to calm down; to cool off; to regain one’s composure; to relax​; to be frightened (at); to be scared (of)​
日差し (hizashi): sunlight; rays of the sun​
保護者 (hogosha): guardian; protector; patron; parent​
保育園 (hoikuen): nursery school; day nursery; preschool​
保育所 (hoikusho): nursery school; nursery​
補助 (hojo): assistance; support; aid; help​; subsidy; supplement; subvention; grant-in-aid​
歩行 (hokou): walk
本番 (honban): performance; take; going before an audience or on-air​; game; season; crucial moment​
本業 (hongyou): principal occupation; core business​
本格 (honkaku): original method or procedure; serious; orthodox; classical; genuine​
本日 (honjitsu): today
本来 (honrai): originally; primarily​; essentially; intrinsically; naturally; by nature; in (and of) itself​
本社 (honsha): head office; main office; headquarters; parent company; this company; this shrine​
本心 (honshin): true feelings​
保守 (hoshu): maintenance; conservatism; conservativeness; conservation​
補足 (hosoku): supplement; complement​
細長い (hosonagai): long and narrow​
舗装 (hosou): pavement; road surface​
欲する (hossuru): to want; to desire
包丁 (houchou): kitchen knife; carving knife​
報道 (houdou): information; report; journalism; news​
放映 (houei): televising; broadcasting; airing​
放課後 (houkago): after school​
子供たちは、放課後集まって宿題をしている。
報告書 (houkokusho): (written) report​
方面 (houmen): direction; district; area​
方針 (houshin): policy; plan; course; principle; objective​
表示 (hyouji): indication; expression; showing; manifestation; demonstration​; display; displaying
評論 (hyouron): criticism; critique​
表紙 (hyoushi): cover (of a book, magazine, etc.); binding​
異 (i): (prefix) different
居場所 (ibasho): whereabouts; place; location; place where one belongs; where one fits in; place where one can be oneself​
いちいち: one-by-one; separately; every single; each and every; without omission; fully; in detail​
一段 (ichidan): more; much more; still more; all the more​
一段落 (ichidanraku): reaching a stopping place; settling down (before the next stage); getting to a point where one can rest; completing the first stage (of the work)​
一面 (ichimen): one face; one surface​; the whole surface​; one aspect; one side​; (on) the other hand​
一覧 (ichiran): look; glance; sight; inspection​; summary; list; table; catalog; catalogue​
一例 (ichirei): example; an instance​
一時休業 (ichijikyuugyou): temporary suspension (of business); brief shutdown
著しい (ichijirushii): striking; remarkable; considerable​
一助 (ichijo): help; assistance​
遺伝 (iden): heredity; (genetic) inheritance​
遺伝子 (idenshi): gene; genetic
意外性 (igaisei): unpredictability; element of surprise​
意義 (igi): meaning; significance​
居心地 (igokochi): comfort
いい加減 (iikagen): irresponsible; perfunctory; careless​; lukewarm; half-baked; halfhearted; vague​; reasonable; moderate
言い訳 (iiwake): excuse; explanation
意地悪 (ijiwaru): malicious; ill-tempered; unkind​
怒り (ikari): anger; rage; fury; wrath; indignation​
生かす (ikasu): to make (the best) use of; to put to good use; to leverage (skills, attributes, experience, etc.); to capitalise on (experience, etc.)​
生き生き (ikiiki): in a lively way; vividly; freshly; animatedly; actively; energetically​
いきなり: abruptly; suddenly; all of a sudden; without warning
生き残る (ikinokoru): to survive​
息抜き (ikinuki): taking a breather; relaxation; vent hole​
一見 (ikken): look; glimpse; glance​; apparently; seemingly​
一気に (ikki ni): in one go; in one gulp; in one breath; without stopping; without pausing; without resting; in one sitting; at a stretch; all at once​
一向に (ikkou ni): completely; absolutely; totally​; (not) at all; (not) a bit; (not) in the least​; earnestly; intently; determinedly​
移行 (ikou): switching over to; migration; transition​
育児 (ikuji): childcare; child-rearing; nursing; upbringing​
育成 (ikusei): rearing; training; nurture; cultivation; promotion​
いまいち: not quite (right); not very good; somewhat (lacking)​
印鑑 (inkan): stamp; seal​
飲料水 (inryousui): drinking water​
印刷物 (insatsubutsu): printed matter​
飲食店 (inshokuten): restaurant
一方的 (ippouteki): one-sided; unilateral; arbitrary​
入れ込む (irekomu): to put in; to place inside; to push into; to stuff into​; to be enthusiastic; to be engrossed​
入り替える (irikaeru): to replace; to substitute; to shift; to change places
衣装 (ishou): clothing; costume; outfit; garment; dress
急ぎ (isogi): haste; hurry; expedition; speed; dispatch​
一斉に (issei ni): simultaneously; all at once; in unison​
傷む (itamu): to be spoiled (e.g. food); to be damaged​
意図 (ito): intention; aim; design​
嫌々 (iyaiya): unwillingly; grudgingly; reluctantly​
意欲 (iyoku): will; desire; ambition; urge (e.g. creative urge)​
痛ましい (itamashii): pitiful; heartbreaking; heartrending; touching; tragic; sad; hurtful​
痛める (itameru): to hurt; to injure; to cause pain​; to harm; to damage; to spoil
一斉に (issei ni): simultaneously; all at once; in unison​
一色 (isshoku): same tendency; everyone being caught up in the same thing​; one color
移転 (iten): moving; relocation; change of address​; transfer (of deeds, property, etc.); demise​
一旦 (ittan): once; for a short time; briefly; temporarily
一定 (ittei): fixed; settled; constant; definite; uniform; regularized; regularised; defined; standardized; standardised; certain; prescribed​
一転 (itten): complete change; reversal; sudden transformation​
居酒屋 (izakaya): izakaya; Japanese bar that also serves various dishes and snacks​
依然 (izen): still; as yet; as it has been
事物 (jibutsu): things; affairs​
実地 (jicchi): practice (as opposed to theory); actual practice​; actual site; (at) the scene; (on) the spot​
自治体 (jichitai): municipality; local government; self-governing body; autonomous body​
児童 (jidou): children; juvenile​
次回 (jikai): next time (occasion)​
事業 (jigyou): project; enterprise; business; industry; operations; venture; service​
時事 (jiji): events of the day; current affairs​
次回 (jikai): next time (occasion)​
時間帯 (jikantai): period of time; time slot; time zone​
自覚 (jikaku): self-consciousness; self-awareness​
実感 (jikkan): real feeling; actual feeling​
実験者 (jikkensha): experimenter; researcher​
じっくり: deliberately; carefully; thoroughly; without rushing​
自己 (jiko): self; oneself​
時給 (jikyuu): hourly pay; hourly wage​
地元 (jimoto): home area; home town​; local
人工物 (jinkoubutsu): artificial object; man-made object; artifact; artefact​
人工知能 (jinkouchinou): artificial intelligence; AI
人材 (jinzai): capable person; talented person​; human resources; personnel​
事例 (jirei): example; precedent; case​
自律 (jiritsu): autonomy (philosophy)​; self-control​
持参 (jisan): bringing; taking; carrying​
自社 (jisha): one’s company; company one works for​
実質 (jisshitsu): substance; essence​; real (in economics, vs. nominal, e.g. real interest rate); substantive; substantial; essential; tangible​
自主 (jishu): independence; autonomy; self-reliance​
自習 (jishuu): self-study; teaching oneself
実績 (jisseki): achievements; actual results; accomplishments; past results; track record​
実践 (jissen): practice; putting into practice; implementation​
実施 (jisshi): enforcement; implementation; putting into practice; carrying out; operation; working (e.g. working parameters); enactment​
自体 (jitai): itself
辞退 (jitai): declining; refusal; nonacceptance; turning down; withdrawal (e.g. of candidacy); pulling out (e.g. of a race); excusing oneself​
時点 (jiten): point in time; occasion​
事典 (jiten): encyclopedia; cyclopedia​
事前 (jizen): prior; beforehand; in advance; before the fact; ex ante
慈善 (jizen): charity; philanthropy​
持続 (jizoku): continuation; persisting; lasting; sustaining; enduring
じたばた: (kicking and) struggling; wriggling; floundering​
序列 (joretsu): rank; ranking order; hierarchy​
助手席 (joshuseki): passenger seat; assistant driver’s seat​
上部 (joubu): top part; surface​
上半身 (jouhanshin): upper half of (one’s) body; upper body; bust
蒸発 (jouhatsu): evaporation; disappearance (of people intentionally concealing their whereabouts); unexplained disappearance​
上位 (joui): superior (in rank); top; ranking​
情景 (joukei): spectacle; sight; scene​
上級者 (joukyuusha): advanced student; advanced learner; advanced practitioner; experienced person​
常温 (jouon): normal temperature; room temperature​
上陸 (jouriku): landing; disembarkation; landfall​
乗車 (jousha): boarding (a train, bus, etc.); getting into (e.g. a taxi)​
上司 (joushi): (one’s) superior; (one’s) boss; the higher-ups​
上昇 (joushou): rising; ascending; climbing​
錠剤 (jouzai): pill; lozenge; tablet​
受動的 (judouteki): passive
受験生 (jukensei): student preparing for or taking examinations (usu. entrance exams); test-taker​
受講 (jukou): taking (attending) lectures​
塾 (juku): coaching school; cramming school; juku​
寿命 (jumyou): life span​
順位 (jun’i): order; rank; position (e.g. in a race); precedence​
循環 (junkan): circulation; rotation; cycle; loop​
順に (jun ni): in order; in turn; one by one​
順序 (junjo): order; sequence; procedure​
順応 (junnou): adaptation; accommodation; conforming; adjustment​; acclimatization
純粋 (junsui): pure; true; genuine; unmixed​
受診 (jushin): having a medical examination; seeing a doctor​
受賞 (jushou): winning (a prize)​
充電 (juuden): charging (electrically)​
充実感 (juujitsukan): sense of fulfillment; sense of completeness; sense of accomplishment; sense of contentment​
充満 (juuman): being filled with; being full of; permeation​
柔軟 (juunan): flexible; lithe; soft; pliable​
充実 (juujitsu): fullness; completion; perfection; enhancement; improvement; enrichment; upgrading​
充実感 (juujitsukan): sense of fulfillment; sense of completeness; sense of accomplishment; sense of contentment​
住宅地 (juutakuchi): housing district; residential district​
重役 (juuyaku): (company) director; executive; top management​; important post; role with heavy responsibilities​
課 (ka): lesson; section (in an organization); division; department​; counter for lessons and chapters (of a book)​
価値観 (kachikan): sense of values; values; value system​
課題 (kadai): subject; theme; issue; matter​; homework; assignment​; task; challenge; problem; question​
過度 (kado): excessive; immoderate​
花粉 (kafun): pollen
花粉症 (kafunshou): hay fever; pollinosis (allergy to pollen)​
輝かしい (kagayakashii): brilliant; glorious; glittering; bright; splendid (e.g. achievement, success); promising (e.g. future)​
輝き (kagayaki): brightness; brilliance; brilliancy; radiance; glitter​
過激 (kageki): extreme; radical​
限り (kagiri): limit; limits; bounds​; degree; extent; scope​
限りない (kagirinai): eternal; unlimited; endless​
嗅ぐ (kagu): to sniff; to smell​
下位 (kai): low rank; lower position; subordinate position; lower order (e.g. byte)​
開封 (kaifuu): opening (an envelope or parcel); breaking the seal; unsealed letter​
介護 (kaigo): nursing; care; caregiving; caring​
介護施設 (kaigoshisetsu): nursing home; rest home
開発 (kaihatsu): development; exploitation​
解放 (kaihou): release; unleashing; liberation; emancipation; setting free​
開放感 (kaihoukan): sense of space; spaciousness​
会員証 (kaiinshou): membership card; membership certificate​
開会 (kaikai): opening of a meeting​
会見 (kaiken): interview; audience; meeting; (viewing) party
解決策 (kaiketsusaku): solution; solution strategy​
開幕 (kaimaku): raising the curtain​; opening (of an event); start of a season
皆無 (kaimu): nonexistent; nil; none; nothing (at all); bugger-all​
飼い主 (kainushi): shepherd; (pet) owner​
回覧 (kairan): circulation (esp. documents); sending round​
改良 (kairyou): improvement; reform​
開催 (kaisai): holding (a conference, exhibition, etc.); opening; hosting (e.g. the Olympics)​
解散 (kaisan): breaking up (e.g. meeting); dispersing (e.g. crowd)​; dissolving (company, organization, etc.); liquidating; disbanding​
改正 (kaisei): revision; amendment; alteration​
開設 (kaisetsu): establishment; opening; setting up; inauguration​
解説 (kaisetsu): explanation; commentary; exposition; elucidation​
買い占める (kaishimeru): to buy up​
解消 (kaishou): cancellation; liquidation; resolution; reduction (e.g. of stress)​
海水浴 (kaisuiyoku): swimming in the ocean; sea bathing; seawater bath; going for a dip in the ocean​
回数 (kaisuu): number of times; frequency; count
改訂 (kaitei): revision (of text); alteration; change
回転 (kaiten): rotation (usu. around something); revolution; turning​
開店 (kaiten): opening a new shop​; opening a shop (for the day)​
回答 (kaitou): reply; answer​
解約 (kaiyaku): cancellation of contract​
果実 (kajitsu): fruit; nut; berry​; profit
過剰 (kajou): excess; surplus; superabundance; overabundance​
係 (kakari): charge; duty; person in charge; official; clerk
欠かせない (kakasenai): indispensable; vital; fundamental; imperative; crucial
欠かす (kakasu): to miss (doing); to fail (to do)​
関わり合う (kakawariau): to get involved or entangled in; to get mixed up in; to have something to do with; to have dealings with​
下記 (kaki): the following
夏期 (kaki): summer term (e.g. school); summer period​
格好つける (kakkou tsukeru): to affect a stylish air; to try to look good; to show off​
隔 (kaku): every other; second; alternate​
格別 (kakubetsu): particular; special; exceptional; especial​
角度 (kakudo): angle
確保 (kakuho): securing; obtaining; ensuring; guarantee; maintaining​
各位 (kakui): everyone; each and every one (of you); ladies and gentlemen​
各自 (kakuji): each (person); everyone; individual; respective​
確率 (kakuritsu): probability; likelihood; chances​
獲得 (kakutoku): acquisition; possession​
格安 (kakuyasu): cheap; reasonable
歓迎会 (kangeikai): welcome party
活発 (kappatsu): lively; active; vigorous; animated; brisk​
係 (kakari): charge; duty; person in charge; official; clerk​
係員 (kakariin): person in charge; official; attendant​
駆け抜ける (kakenukeru): to run past from behind; to run through (e.g. gate, one’s mind)​
拡充 (kakujuu): expansion
確信 (kakushin): conviction; belief; confidence​
確定 (kakutei): decision; settlement​
感 (kan): (prefix) feeling; sensation; emotion; admiration; impression​
叶う (kanau): to come true (of a wish, prayer, etc.); to be realized; to be fulfilled; to suit (e.g. a purpose); to meet (wishes, ideals, etc.); to conform to (standards, rules, etc.); to be consistent with​
完備 (kanbi): (being) fully equipped; (being) fully furnished
勘違い (kanchigai): misunderstanding; mistaken idea; wrong guess​
加熱 (kanetsu): heating; application of heat​
看護 (kango): nursing; (army) nurse​
看護師 (kangoshi): (hospital) nurse; registered nurse​
感じ取る (kanjitoru): to perceive; to sense; to take in; to grasp; to feel​
簡潔 (kanketsu): brevity; conciseness; simplicity​
観光地 (kankouchi): tourist attraction; sight-seeing area​
観念 (kannen): idea; notion; concept; conception​; sense (e.g. of duty)​
完璧 (kanpeki): perfect; complete; flawless​
簡略 (kanryaku): simple; simplicity; brief; brevity​
簡略化 (kanryakuka): simplification
観戦 (kansen): watching a (sports) game; spectating; observing (military operations)​
観測 (kansoku): observation; survey; measurement​
鑑賞 (kanshou): appreciation (of art, music, poetry, etc.)​
観点 (kanten): point of view​
勧誘 (kan’yuu): invitation; solicitation; canvassing; canvasing; inducement; persuasion; encouragement​
絡む (karamu): to entangle; to entwine​; to pick a quarrel; to find fault​
仮に (kari ni): supposing; even if; granting that; for argument’s sake; temporarily; provisionally; for the time being​
軽々 (karugaru): lightly; easily; carelessly​
重なる (kasanaru): to be piled up; to lie on top of one another​; to come one after another; to happen over and over; to pile up (e.g. stress); to accumulate
歌詞 (kashi): song lyrics; words of a song; libretto​
貸し出し (kashidashi): lending; loaning
箇所 (kasho): passage; place; point; part
加速 (kasoku): acceleration; speeding up​
かすか: faint; dim; weak; slight; vague; indistinct; hazy​; poor; wretched; meagre; meager; scanty
課する (kasuru): to levy; to charge; to assess; to impose; to assign​
肩幅 (katahaba): shoulder width (breadth)​
傾く (katamuku): to incline toward; to slant; to lurch; to heel over; to be disposed to; to trend toward; to be prone to​
語りかける (katarikakeru): to make a speech; to address​
偏る (katayoru): to lean (to one side); to incline​; to be unbalanced (e.g. diet); to be unduly weighted towards; to be concentrated on​; to be partial; to be biased; to be prejudiced​
片付け (katazuke): tidying up; finishing
片付く (katazuku): to be put in order; to be put to rights​; to be disposed of; to be solved​
過程 (katei): process; course; mechanism​
下等 (katou): inferior; base; vulgar; low grade; lower class​
活字 (katsuji): printing type; movable type​; printed text; print​
活力 (katsuryoku): vitality; energy; dynamism​
活躍 (katsuyaku): activity (esp. energetic); great efforts; conspicuous service​; to flourish; to participate actively; to play an active role​
可愛がる (kawaigaru): to love; to cherish; to be affectionate to; to treat tenderly; to dote on​; to show favouritism to; to be partial to​
変わった (kawatta): another; different; various; particular; unusual; novel; peculiar
かゆい: itchy
飾り付け (kazaritsuke): decoration; arrangement​
数々 (kazukazu): many; numerous; various; large number of​
数多く (kazuooku): in great numbers​
決着 (kecchaku): conclusion; decision; end; settlement​
気配 (kehai): indication; sign; hint; presence; trend​
警備 (keibi): defense; defence; guard; policing; security​
警備員 (keibihin): guard; security (officer); guardsman​
経営者 (keieisha): manager; proprietor​
軽減 (keigen): abatement; reduction​
経費 (keihi): expenses; cost; outlay​
契機 (keiki): opportunity; chance​; trigger; cause​
蛍光灯 (keikoutou): fluorescent lamp; fluorescent light​
経理 (keiri): accounting; administration (of money)​
掲載 (keisai): publication (e.g. of an article in a newspaper); carrying (e.g. a story); running (e.g. a serial); insertion (e.g. of an advertisement); printing; posting (e.g. on the web)​
軽視 (keishi): making light of; thinking little of; slighting; belittling; dismissing; contempt; disdain​
形式 (keishiki): form (as opposed to substance); formality​
計測 (keisoku): measuring; measurement​
携帯 (keitai): something carried (in the hand); handheld; portable​; mobile telephone; cell phone​ (abbreviation)
毛糸 (keito): knitting wool; woollen yarn​
系統 (keitou): system; lineage; ancestry; family line​; group (e.g. of colors) (colours); family (e.g. of languages); party; school (of thought)​
継続 (keizoku): continuation
謙虚 (kenkyo): modest; humble​
検索 (kensaku): looking up (e.g. a word in a dictionary); retrieval (e.g. data); searching for; referring to​
検診 (kenshin): physical examination; medical examination; health checkup; health screening​
研修 (kenshuu): training (esp. in-service); induction course​
研修会 (kenshuukai): workshop; training course​
謙遜 (kenson): modesty; humility; being humble​
決勝 (kesshou): decision of a contest; finals (in sports)​
決勝戦 (kesshousen): championship game; finals (of a tournament); deciding round​
桁 (keta): column; beam; girder; crossbeam; spar; yard​; digit; decade; order of magnitude​
決断 (ketsudan): decision; determination​
険しい (kewashii): precipitous; rugged; inaccessible; impregnable; steep​; grim; severe; stern​
削る (kezuru): to shave (wood, leather, etc.); to sharpen (e.g. pencil); to plane; to whittle; to pare; to scrape off; to erode​; to cut down (budget, expenses, staff, time, etc.); to curtail; to reduce​
気が重い (ki ga omoi): depressed; bummed out; down; heavy-hearted; heavy-spirited; feeling reluctant (to do)​
気が進まない (ki ga susumanai): reluctant to; not inclined to; disinclined; unwilling​
気を落とす (ki o otosu): to be discouraged; to be disheartened​
気を使う (ki o tsukau): to pay attention to another’s needs; to attend to; to fuss about; to take into consideration​
気を失う (ki o ushinau): to lose consciousness; to faint; to black out​
機敏 (kibin): clever; shrewd; canny; smart; quick; prompt​
規模 (kibo): scale; scope; plan; structure​
気分転換 (kibuntenkan): change of pace; change of mood; (mental) break (e.g. going for a walk); refreshment
きっちり: exactly; precisely; punctually; on the dot; closely; tightly; (fitting) perfectly​; properly; without fail​
気軽 (kigaru): carefree; buoyant; lighthearted; sprightly​
器具 (kigu): utensil; apparatus; implement; device; gadget​
期日 (kijitsu): fixed date; settlement date​
企画 (kikaku): planning; project; plan; design​
機器 (kiki): device; equipment; machinery; apparatus​
聞き手 (kikite): hearer; listener; audience; interviewer; questioner​
聞き取る (kikitoru): to catch (a person’s words); to make out; to follow; to understand​
気配り (kikubari): care; attentiveness; attention; consideration (for others); solicitude​
決め付ける (kimetsukeru): to fix upon (one-sidedly); to (ignore somebody’s position and) arbitrarily decide something is the case​
緊張感 (kinchoukan): feeling of tension; air of tension; tension; nervousness
金魚 (kingyo): goldfish
勤務 (kinmu): service; duty; work​
近年 (kinnen): recent years​
近隣 (kinrin): neighborhood; vicinity​
絹 (kinu): silk
金融 (kinyuu): finance; financing; credit transacting; loaning of money; circulation of money​
きっぱり: clearly; plainly; distinctly
気楽 (kiraku): carefree; comfortable; at ease​; easygoing; happy-go-lucky​
切り上げる (kiriageru): to close (at a certain point); to cut short; to stop early; to finish (at a convenient spot)​; to round up (number)​
切り取る (kiritoru): to cut off; to excise; to tear off; to cut out; to whittle down; to tear out; to cut down; to amputate​
帰省 (kisei): homecoming; returning home​
貴社 (kisha): your company​ (honorific)
気象 (kishou): weather; climate
機種 (kishu): type of equipment; model​
競う (kisou): to compete; to contend; to vie; to contest​
鍛える (kitaeru): to forge; to temper​; to drill; to train; to discipline​
規定 (kitei): stipulation; prescription; provision; regulation; rule​
刻み込む (kizamikomu): to etch (name, etc.); to carve (design)​
刻む (kizamu): to mince; to cut fine; to chop up; to hash; to shred​; to carve; to engrave; to chisel; to notch
傷物 (kizumono): defective article; damaged goods​
個別 (kobetsu): particular case; discrete; individual; separate
こだわり: obsession; fixation; hangup; determination; fastidiousness; pickiness about (trait, style, etc.)​; complaining; criticizing​​
拘る (kodawaru): to fuss over; to be particular about​
孤独 (kodoku): solitude; loneliness; isolation​
古風 (kofuu): old-fashioned; archaic; antique; antiquated​
小金 (kogane): small sum of money​
小柄 (kogara): small build; small stature; petite​
焦げる (kogeru): to burn; to scorch; to char; to singe​
個人差 (kojinsa): individual differences; personal equation​
個々 (koko): individual; one by one; separate​
心地良い (kokochiyoi): comfortable; pleasant​
試み (kokoromi): attempt; trial; experiment​; endeavour (endeavor); effort; venture; initiative​
心強い (kokorozuyoi): heartening; reassuring​
快い (kokoroyoi): pleasant; agreeable; comfortable; refreshing​
細やか (komayaka): tender; warm; caring; thoughtful​; meticulous; detailed; attentive​
小物 (komono): accessories; small articles​
根元/根本 (kongen): root; source; origin; foundation; base; principle​
根性 (konjou): willpower; guts; determination; grit; spirit​; character; nature; disposition; personality​
根気 (konki): patience; perseverance; persistence; tenacity; energy​
今年度 (konnendo): this year; this fiscal year; this school year​
好ましい (konomashii): nice; likeable; desirable​
この度 (konotabi): this occasion; at this time; now​
孤立 (koritsu): isolation; being alone; being friendless
個性 (kosei): individuality; personality; idiosyncrasy; character; individual characteristic
子育て (kosodate): child rearing; child raising; raising children; parenting
応える (kotaeru): to respond; to answer; to meet (e.g. demands, expectations)​
個体 (kotai): individual; specimen​
固定 (kotei): fixing (in place); securing; anchoring; fastening down​; fixing (e.g. salary, capital); keeping the same
古典 (koten): classic (work, esp. book); the classics​
言葉遣い (kotobazukai): speech; expression; wording; language
事柄 (kotogara): matter; thing; affair; circumstance​
こつこつ: unflaggingly; steadily; untiringly; laboriously​; knocking; tapping; clicking; drumming​
高 (kou): (prefix) high
好調 (kouchou): favorable; promising; satisfactory; in good shape​
高度 (koudo): altitude; height; elevation​; high-degree; high-grade; advanced; sophisticated; strong​
行動力 (koudouryoku): ability to take action; energy; fire; dynamism; leverage
公演 (kouen): public performance​
校外 (kougai): out-of-school; off-campus
公害 (kougai): pollution; public nuisance; contamination​
後半 (kouhan): second half; latter half​
高品質 (kouhinshitsu): high quality
好印象 (kouinshou): good impression; favorable impression​
向上 (koujou): elevation; rise; improvement; advancement; progress​
恒常 (koujou): constancy; permanence
公開 (koukai): opening to the public; making available to the public; putting on display; exhibiting; showing (play, movie, etc.); holding (interview, etc.); open; public​
好感 (koukan): good feeling; good will; favourable impression; favorable impression​
後期 (kouki): latter period; second half; late stage; third trimester; second semester
高級 (koukyuu): high class; high grade​; high rank; seniority​
交流会 (koukyuukai): gathering; mixer; meetup; assembly; social; exchange meeting​
項目 (koumoku): item; heading; category; clause​; headword (in a dictionary, encyclopedia, etc.); entry
高熱 (kounetsu): high fever​
光熱費 (kounetsuhi): cost of fuel and lighting; cost of heat and electricity; energy bill; utility cost​
好悪 (kouo): likes and dislikes​
高齢 (kourei): advanced age; old age​
高齢化 (koureika): population ageing (aging)​
高齢者 (koureisha): old person; old people​
小売 (kouri): retail
効率 (kouritsu): efficiency
公立 (kouritsu): public (institution)​
効力 (kouryoku): effect; efficacy; validity; potency​
工作 (kousaku): handicraft; work; construction; manufacturing​; maneuvering; manoeuvering​
考察 (kousatsu): consideration; inquiry; enquiry; investigation; study​
公正 (kousei): justice; fairness; impartiality​
光線 (kousen): beam; light ray
講師 (koushi): lecturer
更新 (koushin): renewal; update; innovation; improvement​
公衆 (koushuu): the public; general public​
高層 (kousou): multistory; multistoried; high-rise; high; tall​
香水 (kousui): perfume
交代 (koutai): alternation; change; relief; relay; shift; substitution (sports, etc.); taking turns​
肯定 (koutei): affirmation
紅葉 (kouyou): autumn colours; fall colors; leaves changing color
効用 (kouyou): use; utility; effect; benefit​
口座 (kouza): account (e.g. bank)​
講座 (kouza): course (e.g. of lectures)​; academic teaching unit; lectureship; professorial chair​
構造 (kouzou): structure; construction; makeup; framework; organization; pattern​
小遣い (kozukai): pocket money; spending money; pin money; allowance
怖がる (kowagaru): to be afraid of; to fear; to dread; to be nervous (about); to be shy (of)​
苦 (ku): pain; anguish; suffering; distress; anxiety; worry; trouble; difficulty; hardship
砕く (kudaku): to break, to smash
くどい: verbose; importunate; wordy; repetitious; long-winded; heavy (taste); rich; strong; cloying; gaudy; loud
区切り (kugiri): punctuation; pause; juncture​; end; (place to) stop​
苦情 (kujou): complaint; troubles; objection; grievance​
組み替える (kumikaeru): to rearrange (classes); to recompose; to reset; to recombine (genes)​
組み込む (kumikomu): to insert; to include; to incorporate; to cut in (printing)​
暗闇 (kurayami): darkness; the dark​
繰り返し (kurikaeshi): repetition; repeat; reiteration; iteration; refrain; cycle​; repeatedly
車椅子 (kurumaisu): wheelchair; folding push-chair
苦戦 (kusen): hard fight; close game; struggle; tight contest​
国々 (kuniguni): countries
くしゃみ: sneeze
くたくた: exhausted; tired; withered; worn out​
空洞 (kuudou): cave; hollow; cavity​
空間 (kuukan): space; room; airspace​
空席 (kuuseki): empty seat; unoccupied seat​; vacancy; vacant post​
空想 (kuusou): daydream; fantasy; fancy; vision
悔やむ (kuyamu): to mourn; to lament​; to be sorry; to regret; to repent​
崩す (kuzusu): to destroy; to demolish; to pull down; to tear down; to level​; to break (a bill); to change; to make change​
客観的 (kyakkanteki): objective
客席 (kyakuseki): guest seating (e.g. theater, stadium); passenger seat (e.g. taxi)​; audience
拒否 (kyohi): refusal; rejection; denial; veto​
曲線 (kyokusen): curve
極端 (kyokutan): extreme; extremity​
強風 (kyoufuu): strong wind; high wind; moderate gale​
教員 (kyouin): teacher; instructor; teaching staff; faculty member​
強弱 (kyoujaku): strength and weakness; (degree of) strength​; stress (of a sound); loudness​
強化 (kyouka): strengthening; intensifying; reinforcement; enhancement; solidification​
協会 (kyoukai): association; society; organization; organisation​
教師 (kyoushi): teacher (classroom)​
恐縮 (kyoushuku): feeling obliged; being grateful; being thankful; being sorry; being ashamed​
教養 (kyouyou): cultivation; refinement; culture; education​
共有 (kyouyuu): joint ownership; co-ownership; sharing (e.g. a viewpoint)​
旧  (kyuu): ex-; former; old​
休暇明け (kyuukaake): post-vacation
急病 (kyuubyou): sudden illness​
休業 (kyuugyou): closed (e.g. store); business suspended; shutdown; holiday​
求人 (kyuujin): recruiting; job offer; job vacancy​
休養 (kyuuyou): rest; break; recreation; recuperation; convalescence​
急増 (kyuuzou): rapid increase; proliferation; surge; explosion​
町並み (machinami): townscape; street (of stores and houses); (look of) stores and houses on street​
まぶた: eyelid; eyelids​
間近 (madjika): proximity; nearness; soon; nearby​
窓際 (madogiwa): (at the) window​
窓口 (madoguchi): ticket window; teller window; counter​; contact person; point of contact​
魔法 (mahou): magic; witchcraft; sorcery​
前向き (maemuki): front-facing; forward-looking; positive; constructive
間際 (magiwa): the point just before; the point of doing; the verge of happening​
巻き込む (makikomu): to roll up; to enfold; to swallow up​; to involve; to drag into​
まく: to scatter; to sprinkle; to strew​
真似る (maneru): to mimic; to imitate​
満員 (man’in): full house; no vacancy; sold out; standing room only; full (of people); crowded​
満足度 (manzokudo): (degree of) satisfaction​
稀 (mare): rare, seldom
真っ先 (massaki): the head; the foremost; beginning; the very front​
真っ白 (masshiro): pure white​
まとめる: to collect; to put (it all) together; to integrate; to consolidate; to unify​; to summarize; to aggregate​; to bring to a conclusion; to finalize; to settle; to put in order
目 (me): (suffix) ordinal number suffix​
目に触れる (me ni fureru)
目新しい (meatarashii): original; novel; new​
目当て (meate): mark; guide; landmark​; purpose; aim; goal; intention; end
目立つ (medatsu): to be conspicuous; to stand out​
恵み (megumi): blessing; grace​
恵む (megumu): to bless; to show mercy to​; to give (money, etc.)​
名簿 (meibo): register of names; list of names; roll; register; roster
名物 (meibutsu): famous product; special product; speciality; specialty
名産 (meisan): noted product; local specialty
名刺 (meishi): business card​
明示 (meiji): elucidation; explicit statement; specification​
明確 (meikaku): clear; precise; definite; distinct​
名門 (meimon): noted family; noble family​; prestigious school, organization, business, etc.
明瞭 (meiryou): clear; plain; distinct; obvious; evident; articulate
名所 (meisho): famous place
目印 (mejirushi): mark; sign; landmark; benchmark​
面会 (menkai): meeting (face-to-face); interview​
面する (mensuru): to face on; to look out on to​
目線 (mesen): one’s gaze​; point of view; standpoint​
目覚める (mezameru): to wake up; to awake​; to awaken to (instinct, ability, perception, etc.); to become aware of; to become conscious of; to realize​; to come to one’s senses​
未 (mi): (prefix) not yet; un-​
見合う (miau): to exchange glances​; to correspond; to counterbalance​
身振り手振り (miburiteburi): gestures; gesturing​
密着 (micchaku): close adhesion; sticking firmly to; being glued to​
道案内 (michiannai): guidance; showing the way; guide​; guidepost; signpost; waymark​
導く (michibiku): to guide; to lead; to show the way; to conduct​
道のり (michinori): distance; journey; itinerary​; path (e.g. to one’s goal); way; process; route; road​
Advertisement
乱れる (midareru): to be disordered; to be disarranged; to be disarrayed; to be disheveled; to be dishevelled​
見出し (midashi): heading; headline; title; caption​
見張る (miharu): to stand watch; to stand guard; to look out​
見直す (minaosu): to look at again​; to re-examine; to get a better opinion of; to see in a more positive light​
見慣れる (minareru): to become used to seeing; to be familiar with​
民家 (minka): private house​
見逃す (minogasu): to miss; to overlook; to fail to notice​; to let pass (a matter); to overlook (e.g. a wrongdoing); to turn a blind eye to​
身の回り (mi no mawari): one’s personal belongings; one’s vicinity; one’s daily life; everyday necessities​
民族 (minzoku): people; race; nation; ethnic group; ethnos​
密閉 (mippei): shutting tightly; sealing something airtight​
密接 (missetsu): close (relationship, connection, etc.); intimate; near​; close (together)​
満たす (mitasu): to satisfy (conditions, one’s appetite, etc.); to meet (e.g. demands); to fulfill; to gratify​
見通し (mitooshi): unobstructed view; perspective; visibility; vista​; forecast; outlook; prospect; prediction​; insight; foresight​
見積書 (mitsumorisho): written estimate; quotation; quote​
見積もる (mitsumoru): to estimate​
見分ける (miwakeru): to distinguish; to recognize; to recognise; to tell apart; to differentiate (both figuratively and visually)​
見渡す (miwatasu): to look out over; to survey (scene); to take an extensive view of​
溝 (mizo): ditch; drain; gutter; trench​; groove; tread​; gap (between people, countries, etc.); gulf​
持ち出す (mochidasu): to take out; to carry out; to bring out from where it belongs​; to mention something; to broach a topic; to bring up (a subject)
持ち込む (mochikomu): to take something into …; to bring in; to carry in​
持ち主 (mochinushi): owner; proprietor; possessor (e.g. of talent, beauty, etc.)​
潜る (moguru): to dive (into or under water)​; to get under; to get into; to get in; to creep into; to crawl under; to bury oneself; to burrow into; to dig oneself into; to snuggle under​
模範 (mohan): exemplar; model; example; pattern​
模型 (mokei): model; dummy; maquette​
木製 (mokusei): wooden; made of wood​
目的地 (mokutekichi): place of destination​
木材 (mokuzai): lumber; timber; wood​
問題点 (mondaiten): the problem (at issue); the point at issue; problematic issue; problem
物真似 (monomane): mimicry; imitation (of someone, something)​
物足りない (monotarinai): unsatisfied; unsatisfactory; insufficient​
盛り上がる (moriagaru): to swell; to rise; to bulge; to be piled up​; to rouse; to get excited​
もったいない: wasteful; a waste​; impious; profane; sacrilegious​; too good; more than one deserves; unworthy of​
猛 (mou): (prefix): extreme; severe​
催し (moyooshi): event; festivities; function; social gathering; auspices; opening; holding (a meeting)​
最寄り (moyori): nearest; neighboring; nearby​
無 (mu/bu): (prefix) un-; non-​
無縁 (muen): unrelated; irrelevant; indifferent​; without relations (esp. of a deceased person); having no surviving relatives​cho
無限 (mugen): infinity; infinitude; eternity​; infinite; limitless​
無意識 (muishiki): unconsciousness; unconscious; involuntary; automatic; mechanical; unintentional; spontaneous​
無条件 (mujouken): unconditional
矛盾 (mujun): contradiction; inconsistency​
無関係 (mukankei): unrelated
無関心 (mukanshin): apathetic; indifferent​
昔話 (mukashibanashi): old tale; folk tale; legend​; reminiscence
むかつく: to feel irritated; to feel offended; to feel angry​; to feel sick; to feel nauseous
向き合う (mukiau): to be opposite; to face each other​; to confront (an issue); to face​
無口 (mukuchi): taciturn; reticent; quiet; silent; untalkative​
無給 (mukyuu): unpaid; nonsalaried​
無線 (musen): radio (communication)​; wireless; not using wires
蒸し暑い (mushiatsui): humid; sultry​
結びつく (musubitsuku): to be related; to be connected; to be joined together​; to result in; to lead to; to bring about​
無数 (musuu): innumerable; countless; numberless​
傾らか (nadaraka): gently sloping; gentle; easy​; smooth
長続き (nagatsuzuki): lasting long; continuation; keeping at (something); sticking to (something)​
嘆く (nageku): to lament; to grieve; to regret​; to deplore​
和やか (nagoyaka): mild; calm; gentle; quiet; congenial; amicable; amiable; friendly; genial; harmonious; peaceful​
内 (nai): (suffix) inside; within
内部 (naibu): interior; inside; internal​
内包 (naihou): connotation; comprehension; intension​; inclusion; containment within​
内線 (naisen): phone extension; indoor wiring; inner line​
中庭 (nakaniwa): courtyard; quadrangle; middle court​
生中継 (namachuukei): live broadcast (radio, TV); live coverage​
滑らか (nameraka): smooth (of a surface); glassy; velvety; soft​
何度も (nandomo): many times over; often​
軟弱 (nanjaku): weakness
何らか (nanraka): some; any; in any way; of some kind; of some sort​
慣れ (nare): practice; practising; experience​
成り立つ (naritatsu): to consist of; to be made up of; to be composed of​; to be concluded
成し遂げる (nashitogeru): to accomplish; to finish; to fulfill​
悩み (nayami): trouble; troubles; worry; distress; sorrows; anguish; agony; problem​
名づける (nazukeru): to name; to call; to christen; to term​
値上がり (neagari): price advance; increase in value​
値引き (nebiki): price reduction; discount​
根っこ (nekko): root (of a plant)​; stump (of a tree)​; root (of a problem, etc.); base; foundation; origin; source​
寝転がる (nekorogaru): to lie down; to throw oneself down
年度 (nendo): fiscal year (usu. April 1 to March 31 in Japan); financial year​; academic year; school year​
年金 (nenkin): annuity; pension​
年内 (nennai): by the end of the year​
狙う (nerau): to aim at​; to be after (something); to have an eye on​
熱する (nessuru): to heat up; to heat
根強い (nezuyoi): firmly rooted; deep-seated​
鈍い (nibui): dull (e.g. a knife); blunt​; thickheaded; obtuse; stupid​
日用品 (nichiyouhin): daily necessities​
濁る (nigoru): to become muddy; to become cloudy; to get impure (of a liquid, gas, etc.)​
日課 (nikka): daily lesson; daily work; daily routine​
憎い (nikui): hateful; abominable; poor-looking; detestable​
憎しみ (nikushimi): hatred
認識 (ninshiki): recognition; awareness; perception; understanding; knowledge; cognition; cognizance; cognisance​
偽物 (nisemono): spurious article; forgery; counterfeit; imitation; sham
日数 (nissuu): a number of days​
荷造り (nizukuri): packing; baling; crating​
乗り越える (norikoeru): to climb over; to get over; to ride across​; to overcome; to surpass; to overtake​
乗り継ぐ (noritsugu): to connect (with a different flight, train, etc.); to make a connection; to change (planes, trains, etc.)​
農園 (nouen): plantation
納品 (nouhin): delivery of goods​
濃厚 (nouko): rich (in flavor, color, smell, etc.); thick; dense; strong
能率 (nouritsu): efficiency
農作物 (nousakubutsu): crops; agricultural produce​
農薬 (nouyaku): agricultural chemical (i.e. pesticide, herbicide, fungicide, etc.); agrochemical; agrichemical​
覗く (nozoku): to peek (through a keyhole, gap, etc.)​; to sneak a look at; to take a quick look at​r
入会 (nyuukai): admission; joining; enrollment; enrolment​
入会金 (nyuukaikin): initiation fee; admission fee​
入金 (nyuukin): deposit; payment; money received; money due​
入居 (nyuukyo): moving into (house)​
入居者 (nyuukyosha): tenant (esp. residential tenant in apartment block); occupant; inhabitant; inmate​
入門 (nyuumon): entering an institution; beginning training​; primer; manual; introduction (to)​
乳製品 (nyuuseihin): dairy products​
覚え書き (oboegaki): memo; memorandum; note​
落ち込む (ochikomu): to feel down; to feel sad; to be depressed; to be in low spirits​; to be in a slump (business, economy, etc.); to be in an unfavourable condition​
驚き (odoroki): surprise; astonishment; wonder; amazement​
補う (oginau): to compensate for; to supplement​
追い返す (oikaesu): to drive away; to turn away; to send away; to repel; to repulse​
追い求める (oimotomeru): to pursue​
追い越す (oikosu): to pass (e.g. car); to overtake​; to surpass; to outstrip; to get ahead of; to outdistance​
追い抜く (oinuku): to pass (a car); to overtake; to surpass; to outstrip; to outdistance; to outsail
おかしな: ridiculous; odd
臆病 (okubyou): cowardly; timid; easily frightened​
屋外 (okugai): outdoors; alfresco​
遅れ (okure): delay; lag; postponement; falling behind​
奥底 (okusoko): depths; bottom (of one’s heart)​
思いがけない (omoigakenai): unexpected; contrary to expectations; by chance; casual​
思い返す (omoikaesu): to re-think; to think back upon; to change one’s mind
思い切り (omoikiri): with all one’s strength; with all one’s heart; to the utmost​; resolution; decisiveness​
思い込み (omoikomi): wrong impression; subjective impression; assumption; prejudice​
思い立つ (omoitatsu): to set one’s mind on doing; to get the idea of doing; to make up one’s mind​
思いつき (omoitsuki): plan; idea; suggestion​
思いつく (omoitsuku): to think of; to hit upon; to come into one’s mind; to be struck with an idea​; to remember; to recall​
思い浮かぶ (omoiukabu): to occur to; to remind of; to come to mind​
重苦しい (omokurushii): heavy; gloomy; awkward; cumbrous; oppressive; leaden​
重み (omomi): weight
お似合い (oniai): well-matched (esp. of a couple); becoming; suitable​
恩恵 (onkei): grace; favor; favour; blessing; benefit​
温厚 (onkou): gentle; mild-mannered​
音量 (onryou): volume (sound)​
大通り (oodoori): main street
大げさ (oogesa): grandiose; exaggerated​
大声 (oogoe): loud voice
大幅 (oohaba): big; large; drastic; substantial​
多く (ooku): many; much; largely; abundantly; mostly​
多目に (oome ni): plenty; lots
大手 (oote): major company; big company​
折り返し (orikaeshi): by return; (call or write back) without delay​
折り畳む (oritatamu): to fold up; to fold into layers​
収まる (osamaru): to fit into (a box, frame, category, etc.); to be contained within; to fall within (e.g. a budget)​
納める (osameru): to dedicate; to make an offering; to pay (fees)​
おしゃれ: smartly dressed; stylish; fashion-conscious​; someone smartly dressed​; to dress up; to be fashionable
惜しい (oshii): regrettable; disappointing; unfortunate​; precious; dear; valuable​
押し付ける (oshitsukeru): to press; to push; to force​; to foist on (task, responsibility); to impose (one’s will)​
教わる (osowaru): to be taught (by); to learn from​
お勧め (osusume): recommendation; advice; suggestion; encouragement​
お手本 (otehon): example; role model
お手数 (otesuu): trouble; bother​
お得 (otoku): economical; bargain; good value; good-value​
大人しい (otonashii): obedient; docile; quiet​
訪れる (otozureru): to visit; to call on​; to arrive; to come; to appear​
欧米 (oubei): Europe and America; the West​
応募者 (oubosha): applicant
応答 (outou): reply; answer; response​
親子 (oyako): parent and child​
および: and; as well as​
来日 (rainichi): arrival in Japan; coming to Japan; visit to Japan​
来学期 (raigakki): next semester
来場 (raijou): attendance
来場者 (raijousha): those attending​
来年度 (rainendo): next year; next fiscal year​
来店 (raiten): coming to a store (restaurant, bar, shop, etc.)​
来店者 (raitensha): visitor (to a shop or restaurant); customer (visiting a store or restaurant); patron​
楽観 (rakkan): optimism; taking an optimistic view​
欄 (ran): section (e.g. in a newspaper); column; page​; field (in a form, web page, etc.); blank​
乱暴 (ranbou): violence; assault; running riot​; rough (e.g. handling); reckless; careless; coarse; rude; unreasonable (e.g. demand); wild (e.g. argument)​
冷房 (reibou): cooling; air-conditioning​
例外 (reigai): exception
礼儀作法 (reigisahou): etiquette; courtesy​
冷水 (reisui): cold water​
恋愛 (ren’ai): love; love-making; passion; emotion; affections​
連休 (renkyuu): consecutive holidays​
理解力 (rikairyoku): (power of) understanding; comprehensive faculty​
理系 (rikei): science
陸上 (rikujou): (on) land; ground; shore
裏面 (rimen): back; reverse; other side; inside; tails (of coins); background​
臨時 (rinji): temporary; provisional; interim​; special; extraordinary; extra​
履歴書 (rirekisho): personal history; curriculum vitae; resume​
立食 (risshoku): stand-up meal; buffet​
利点 (riten): advantage; point in favor
論戦 (ronsen): verbal dispute​
労働力 (roudouryoku): labor; manpower; working force​
略す (ryakusu): to abbreviate; to omit; to abbreviate; to omit
力 (ryoku): (suffix) strength; power; proficiency; ability​
寮 (ryou): hostel; dormitory​
領域 (ryouiki): area; domain; territory; field; range; region; regime​
了解 (ryoukai): comprehension; consent; understanding; agreement​
緑茶 (ryokucha): green tea; Japanese tea​
両面 (ryoumen): both sides; two sides; double-sided​
両者 (ryousha): pair; the two; both persons; both things​
了承 (ryoushou): acknowledgement; acknowledgment; understanding (e.g. “please be understanding of the mess during our renovation”); noting; acceptance
両端 (ryoutan): both ends; either end; both edges​; double-mindedness; sitting on the fence​
流  (ryuu): (suffix) fashion; way; style; manner​; class; rank; rate​
定める (sadameru): to decide; to determine​; to establish; to lay down; to prescribe; to provide; to stipulate​; to bring peace (to); to make peaceful​
探る (saguru): to feel around for; to fumble for; to grope for; to search for; to look for​; to investigate; to probe into; to spy on; to sound out​
再 (sai): (prefix) re-; again; repeated; deutero-; deuto-; deuter-​
最悪 (saiaku): worst; horrible; horrid; awful; terrible​
栽培 (saibai): cultivation
最大 (saidai): biggest; greatest; largest; maximum
再度 (saido): twice; again; second time​
災害 (saigai): calamity; disaster; misfortune​
再発 (saihatsu): return; relapse; reoccurrence​
再開 (saikai): reopening; resumption; restarting​
細菌 (saikin): bacterium; bacteria; germ​
最高齢 (saikourei): oldest; most advanced age​
再生 (saisei): resuscitation; regeneration; restoration to life​; reformation; rehabilitation​; playback; regeneration (sound, etc.); view (of a video clip)​
最新 (saishin): latest; newest; late-breaking (news)​
最小限 (saishougen): minimum; lowest​
採集 (saishuu): collecting; gathering​
最終日 (saishuubi): last day; final day
最速 (saisoku): fastest
催促 (saisoku): pressing; urging; demanding; demand​
最低限 (saiteigen): minimum; at the very least​
最適 (saiteki): most suitable; optimum; optimal; best​
採用 (saiyou): use; adoption; acceptance​; appointment; employment; engagement; recruitment​
坂道 (sakamichi): hill road
遡る (sakanoboru): to go upstream; to go back (in time, to origin); to date back to; to trace back to; to make retroactive
先々 (sakizaki): distant future; inevitable future​; places one goes to​
早急 (sakkyuu): immediate; prompt; quick; rapid; urgent; pressing​
作成 (sakusei): drawing up (e.g. legal document, contract, will, etc.); preparing; writing; framing; making; producing; creating; creation
妨げる (samatageru): to disturb; to prevent; to obstruct; to hinder​
山頂 (sanchou): summit (of a mountain)​
参観 (sankan): visit; inspection​
参照 (sanshou): reference; bibliographical reference; consultation; browsing (e.g. when selecting a file to upload on a computer); checking out​
皿洗い (saraarai): washing-up; dish-washing​
さらさら: rustling; murmuring; fluently; silky; smooth and dry; free-flowing​
猿真似 (sarumane): indiscriminate imitation; monkey see, monkey do; blind follower
細やか (sasayaka): meagre; meager; modest
ささやく: to whisper; to murmur​​
差し出す (sashidasu): to present; to submit; to tender; to hold out​
差し引く (sashihiku): to deduct; to take away; to dock​; to make allowances for something; to bear something in mind
差し支える (sashitsukaeru): to interfere; to hinder; to become impeded​
さっさ: promptly; immediately; quickly; without delay​
早速 (sassoku): at once; immediately; without delay; promptly​
撮影 (satsuei): photography (still or motion); photographing; filming; shooting; (video) recording​
刺す (sasu): to pierce; to stab; to prick; to stick; to thrust​; to sting; to bite
さわやか: fresh; refreshing; invigorating​
狭める (sebameru): to narrow; to reduce; to contract​
接着 (secchaku): adhesion; glueing; gluing; bonding; binding; adhering; fastening​
設置 (secchi): establishment; institution​; installation (of a machine or equipment)​
制 (sei): (suffix) system; organization; organisation; imperial command; laws; regulation; control; government; suppression; restraint; holding back; establishment​
整備 (seibi): maintenance; servicing​; putting in place; establishment; development; preparation; provision; outfitting​
成分 (seibun): ingredient; component; composition​
声援 (seien): (shout of) encouragement; cheering; rooting; support​
精一杯 (seiippai): the best one can do; one’s best effort​; with all one’s might; to the best of one’s ability​
成果 (seika)​: (good) result; outcome; fruits (of one’s labors); product; accomplishment​
生計 (seikei): livelihood; living​
正門 (seimon): main gate; main entrance​
製作 (seisaku): manufacture; production​
制作 (seisaku): work (film, book)​; production; creation; turning (something) out; development​
政策 (seisaku): political measures; policy​
清算 (seisan): settlement (financial); squaring accounts; clearing debts​; liquidation; ending (a relationship); breaking up (with); burying (the past); redeeming (one’s faults)​
精神力 (seishinryoku): emotional strength; force of will​
性質 (seishitsu): nature; property; disposition​
清掃 (seisou): cleaning; clean-up; garbage collection; scavenging​
生得的 (seitokuteki): innate; inherent; natural; inborn​
生命力 (seimeiryoku): vitality; (one’s) life force​
性能 (seinou): ability; performance; efficiency​
成立 (seiritsu): formation; establishment; materialization; coming into existence​; conclusion (e.g. of a deal); approval; completion; arrangement​
生産者 (seisansha): manufacturer; producer​
政党 (seitou): political party​
設計者 (sekkeisha): designer
設計図 (sekkeizu): plan; blueprint​
説教 (sekkyou): remonstration; scolding; lecturing​
選抜 (senbatsu): selection; choice; picking out​
選別 (senbetsu): selection; classification; sorting; screening; triage​
先着 (senchaku): arriving first​
戦後 (sengo): postwar period; period after Second World War​
専業主婦 (sengyoushufu): housewife
選考 (senkou): selection; screening​
選挙 (senkyo): election
鮮明 (senmei): vivid; clear; distinct​
専門書 (senmonsho): technical book; specialized book; treatise​
専門店 (senmonten): specialist shop; shop specializing in a few types of product​
専念 (sennen): absorption; giving undivided attention; devoting oneself (to)​
洗練 (senren): polish; refinement​
線路 (senro): railway track; railway line; railroad; railway; track; line
戦略 (senryaku): strategy; tactics​
先先週 (sensenshuu): week before last​
洗濯機 (sentakuki): washing machine (laundry)​
洗剤 (senzai): detergent; cleanser; cleaning agent; washing material​
接する (sessuru): to touch; to come in contact with; to border on; to adjoin; to be adjacent; to be close​; to receive (e.g. visitor); to attend to; to serve; to take care of; to look after; to deal with; to see​
選出 (senshutsu): election; selection; choice​
選択肢 (sentakushi): choices; alternatives; options​
先端 (sentan): pointed end; tip; point; forefront; vanguard; spearhead; leading edge​
接続 (setsuzoku): connection; attachment; union; join; joint; link
専用 (sen’you): exclusive use; personal use; dedicated​
専属 (senzoku): exclusive; attached to; specialist​
背負う (seou): to carry on one’s back​; to be burdened with; to take responsibility for​
設定 (settei): establishment; creation; posing (a problem); setting (movie, novel, etc.); scene​; options setting; preference settings; configuration; setup
説得力 (settokuryoku): persuasiveness; powers of persuasion; cogency​
節電 (setsuden): conservation of electricity; brownout​
車内 (shanai): inside a train, car, etc.​
社内 (shanai): within a company; in-house​
車両 (sharyou): rolling stock; railroad cars; wheeled vehicles​
写生 (shasei): sketching; drawing from nature; portrayal; description​
写真家 (shashinka): photographer
車窓 (shasou): train window; car window​
仕上げる (shiageru): to finish up; to complete; to finish off; to get through; to polish off​
痺れる (shibireru): to become numb; to go to sleep (e.g. a limb)​; to get an electric shock; to tingle (from an electric shock)​; to be excited; to be titillated; to be mesmerized; to be enthralled
絞る (shiboru): to wring (towel, rag); to squeeze; to press; to extract; to milk; to extort; to exploit​
志望 (shibou): wish; desire; ambition​
脂肪 (shibou): fat; grease; blubber; lard; suet​
渋い (shibui): astringent; bitter; puckery; rough; harsh; tart​; austere; elegant (and unobtrusive); refined; quiet (and simple); sober; sombre; subdued; tasteful (in a quiet way); understated​; sour (look); glum; grim; sullen; sulky​
試着 (shichaku): trying on clothes​
市長 (shichou): mayor
支援 (shien): support; backing; aid; assistance​
志願 (shigan): aspiration; volunteering; desire; application​
志願者 (shigansha): applicant; candidate
仕草 (shigusa): gesture; movement; action; behavior; behaviour; bearing; mannerism​
指標 (shihyou): index; indices; indicator​
支持 (shiji): support; backing; endorsement; approval​
司会 (shikai): leading a meeting; presiding over a meeting; officiating at a ceremony; chairmanship​; chairman; presenter; host; moderator; master of ceremonies
視界 (shikai): field of vision; visibility; view; visual field; (one’s) ken​
資格 (shikaku): qualifications; requirements; capabilities​
視覚 (shikaku): sense of sight; vision​
思考 (shikou): thought; consideration; thinking​
思考力 (shikouryoku): ability to think​
試行錯誤 (shikousakugo): trial and error
仕組み (shikumi): structure; construction; arrangement; contrivance; mechanism; workings​; plan; plot; contrivance​
至急 (shikyuu): urgent; pressing; immediate; prompt; express​; urgently; promptly; at once; right away; without delay; as soon as possible​
氏名 (shimei): full name; identity​
使命 (shimei): mission; errand​; task; duty; obligation​
締め切る (shimekiru): to close up​; to shut up (e.g. behind doors)​; to cut off (e.g. because a deadline has expired); to close off (e.g. subscription list)​
湿っぽい (shimeppoi): damp; humid; wet​; gloomy; melancholy​
湿る (shimeru): to become damp; to become moist; to become wet​
染み付く (shimitsuku): to be indelibly stained or ingrained; to be dyed in deeply​
芯 (shin): wick; marrow; staple (for stapler); (pencil) lead; stuffing; pith​; core; heart; centre; center
新 (shin): (prefix) new; neo-​
新築 (shinchiku): new building; new construction​
振動 (shindou): oscillation; vibration; swing (e.g. of a pendulum)​
進化 (shinka): evolution; progress​
進行 (shinkou): moving forward (e.g. vehicle); onward movement​; advance (work, procedure, etc.); advancement; progress​
真の (shinno): true; real; genuine; proper; utter​
進入 (shinnyuu): entry; approach; penetration​
新設 (shinsetsu): establishing; founding; setting up; organizing; establishment​
進出 (shinshutsu): advance; stepping forward; emerging
深夜 (shin’ya): late at night​
信頼性 (shinraisei): credibility; authenticity; confidence; reliability​
素人 (shirouto): amateur; layman; ordinary person; novice
視力 (shiryoku): eyesight
新品 (shinpin): (brand-)new article​
申請 (shinsei): application; request; petition​
申請書 (shinseisho): written application​
視察 (shisatsu): inspection; observation​
施設 (shisetsu): institution; establishment; facility​
質素 (shisso): simple; plain​; modest; frugal; reserved​
下書き (shitagaki): draft; rough copy​
親しむ (shitashimu): to be intimate with; to befriend​
指摘 (shiteki): pointing out; identification​
視点 (shiten): opinion; point of view; visual point​
しわ: wrinkle; crease​; ripple
視野 (shiya): field of vision; view​; one’s outlook (e.g. on life); one’s horizons​
自然界 (shizenkai): nature; the natural world; realm of nature​
沈める (shizumeru): to sink; to submerge​; to floor (an opponent)​
諸 (sho): various; many; several​
初夏 (shoka): early summer
初回 (shokai): first time; first innings; initial attempt​
初期 (shoki): early (days); initial stage​; initial
食器類 (shokkirui): dinnerware; cutlery​
食 (shoku): (counter) meal
食費 (shokuhi): food expense​
職員 (shokuin): staff member; personnel​
職人 (shokunin): craftsman; artisan; tradesman; worker; workman​
食生活 (shokuseikatsu): eating habits​
初心者 (shoshinsha): beginner
初対面 (shotaimen)
書店 (shoten): bookshop; bookstore​
象徴 (shouchou): (abstract) symbol; emblem; representation
商業 (shougyou): commerce; trade; business​
勝敗 (shouhai): victory or defeat; issue (of battle); outcome​
賞品 (shouhin): prize; trophy
消費者 (shouhisha): consumer
生じる (shoujiru): to produce; to yield; to cause​; to result from; to arise; to be generated​
消化 (shouka): digestion (of food)​; digestion (of information); assimilation; thorough understanding​; consumption; absorption; using up; meeting (e.g. a quota); completion​
消極的 (shoukyokuteki): negative; passive; half-hearted; unmotivated​
照明 (shoumei): illumination; lighting​
正面 (shoumen): front; frontage; facade; main​
消耗 (shoumou): exhaustion; consumption; using up; dissipation; waste
小児科 (shounika): pediatrics
省略 (shouryaku): omission; abbreviation; abridgment; abridgement
詳細 (shousai): details; particulars; specifics​; detailed; specific; minute
少子化 (shoushika): declining birth rates; decrease in the number of children​
消失 (shoushitsu): dying out; disappearance; vanishing; elimination; loss; absence​
少数 (shousuu): minority; few​
焦点 (shouten): focus (e.g. photographic); focal point​
商店街 (shoutengai): shopping district; shopping street; downtown​
所有 (shoyuu): one’s possessions; ownership​
所属 (shozoku): belonging to (a group, organization, etc.); affiliation (with); being attached to; being under the control of​
主人公 (shujinkou): protagonist; main character; hero(ine) (of a story)​
主観 (shukan): subjectivity; subject (philosophical); ego​; one’s personal opinion; one’s own idea​
宿泊先 (shukuhakusaki): lodging place
祝日 (shukujitsu): national holiday; public holiday​
出版社 (shuppansha): publisher; publishing house; publishing company​
出発点 (shuppatsuten): starting point; point of departure​
主力 (shuryoku): main force; chief object; mainline​
主催 (shusai): sponsorship (i.e. conducting under one’s auspices); promotion; organizing; organising; hosting; staging​
出世 (shusse): success in life; getting ahead; successful career; promotion; climbing the corporate ladder; eminence​
出社 (shussha): going to work (e.g. in the morning); coming to work​
出身地 (shusshinchi): birthplace; native place​
出席者 (shussekisha): those present; attendance​
主体 (shutai): main constituent; core; nucleus​; subject (philosophical); protagonist​
取得 (shutoku): acquisition; obtaining; gaining possession; purchase​
出演 (shutsuen): performance; appearance (in a stage, film, TV show, etc.)​
出演者 (shutsuensha): performer; entertainer; actor​
集 (shuu): (suffix) collection; compilation​
修学旅行 (shuugakuryokou): excursion; field trip; school trip​
修業 (shuugyou): pursuit of knowledge; studying; learning; training; completing a course​
周辺 (shuuhen): circumference; outskirts; environs; around; in the area of; in the vicinity of​
周年 (shuunen): whole year; entire year​; -th year anniversary​
収納 (shuunou): storage; putting or stowing away​
秀才 (shuusai): bright person; talented student; prodigy​
就職活動 (shuushokukatsudou): job hunting; job searching​
収集 (shuushuu): collecting; accumulating; gathering​; collection (of art, stamps, insects, etc.)​
習得 (shuutoku): learning; acquisition (of a skill, knowledge, etc.)​
取材 (shuzai): news coverage; collecting data (e.g. for an article); covering (something for media)​
率直 (socchoku): frank; candid; straightforward; openhearted; direct; outspoken​
添える (soeru): to garnish; to accompany (as a card does a gift)​; to add to as support; to prop up​
側面 (sokumen): side; flank; profile; sidelight; lateral​; aspect; dimension​
速達 (sokutatsu): express; special delivery​
測定 (sokutei): measurement
即座に (sokuza): immediately; right away; on the spot​
染まる (somaru): to be dyed​; to be tainted; to be infected; to be stained; to be steeped​
そもそも: in the first place; to begin with; from the start; originally; ab initio
揃える (soroeru): to collect; to gather; to get together; to complete (a collection)​; to arrange; to put in order; to prepare; to get ready​
揃う (sorou): to be complete; to be all present; to make a full set; to be satisfied (of conditions)​; to gather; to assemble; to be collected​
そそっかしい: careless; thoughtless; hasty; rash​
素質 (soshitsu): character; qualities; genius; the makings of​
外側 (sotogawa): exterior; outside; outer; external; lateral​
添う (sou): to meet (wishes, expectations, etc.); to satisfy; to comply with; to live up to
沿う (sou): to run along; to run beside; to stick to (a line)​; to follow (a policy, plan, etc.); to act in accordance with; to align with​
総 (sou): (prefix): whole; all; general; gross; entire; overall​
送付 (soufu): sending (esp. email attachments); forwarding; remitting​
総額 (sougaku): sum total; total amount​
相互 (sougo): mutual; reciprocal​
総合 (sougou): synthesis; coordination; putting together; integration; composite​; comprehensive
相違 (soui): difference; discrepancy; variation​
倉庫 (souko): storehouse; warehouse; godown​
送客 (soukyaku): sending customers (somebody’s way)​
総務 (soumu): general affairs; general business; manager; director; adjutant general​
相応 (souou): suitable; appropriate; befitting; becoming; adequate; reasonable; proper​
創立 (souritsu): establishment; founding; organization; organisation​
送料 (souryou): postage; carriage; shipping charge​
創作 (sousaku): creation; production; creative work (novel, film, etc.); original work; (creative) writing​; fabrication; fiction; invention​
送信 (soushin): transmission; sending​
総数 (sousuu): total (number); count​
相対的 (soutaiteki): relative
そうとう: corresponding to (in meaning, function, etc.); being equivalent to​; appropriate; suitable; befitting; proportionate​
創造 (souzou): creation
騒々しい (souzoushii): noisy; loud; boisterous; clamorous; raucous​; turbulent; unsettled; restless​
素材 (sozai): ingredient; (raw) material; resource​; unprocessed timber; raw timber​
据える (sueru): to place (in position); to fix; to set (e.g. table); to lay (foundation)​; to install; to seat (someone); to settle (upon something); to fix (e.g. one’s gaze)​
水分 (suibun): water; liquid; fluid; moisture; humidity; sap; juice​
垂直 (suichoku): vertical
水平 (suihei): horizontal; level; even​
水面 (suimen): water’s surface​
推薦書 (suisensho): recommendation; nomination​
吸い取る (suitoru): to absorb; to squeeze (money)​
好き嫌い (sukikirai): likes and dislikes; pickiness (about food); choosiness; fussiness; tastes; preferences​
すっきり: refreshingly; with a feeling of relief; pleasantly; (a weight) off one’s shoulder​; shapely; neatly; cleanly; without trouble​
住まい (sumai): dwelling; house; residence; address​
済ます (sumasu): to finish; to get it over with; to conclude​; to settle; to pay back​
隅々 (sumizumi): nooks; corners​
素直 (sunao): obedient; meek; docile; unaffected​; honest; frank; upfront (about one’s feelings)​
すらすら: smoothly; easily; readily
数値 (suuchi): numerical value; numerics​; reading (on a meter, etc.)​
数分 (suufun): several minutes; a few minutes​
数量 (suuryou): quantity; volume; amount​
多 (ta): (prefix): multi-
束ねる (tabaneru): to tie up in a bundle (e.g. straw, hair, bills, letters); to bundle; to sheathe​; to govern; to manage; to control; to administer​
旅先 (tabisaki): destination; goal (of travel); place one stays during a journey​
立ち止まる (tachidomaru): to stop (in one’s tracks); to come to a stop; to halt; to pause; to stand still​
たちまち: in an instant; in a moment; immediately; right away; at once; suddenly; all of a sudden; all at once
多大 (tadai): great (quantity, amount, etc.); huge; enormous; serious​
辿り着く (tadoritsuku): to arrive at (after a struggle); to finally reach; to find one’s way to; to finally hit on (e.g. an idea)​
耐える (taeru): to bear; to stand; to endure; to put up with​; to support; to withstand; to resist; to brave​
多額 (tagaku): large (amount of money); huge; hefty; expensive
多発 (tahatsu): repeated occurrence​
対 (tai): opposite; opposition​; versus; vs.; v.​
大別 (taibetsu): general classification; broad categorization​
体調 (taichou): physical condition; state of health​
体外 (taigai): ectogenesis; outside the body​
対比 (taihi): contrast; comparison
体感 (taikan): bodily sensation; sense; experience​
退場 (taijou): exit (from a stage); leaving; exit​
体格 (taikaku): physique; constitution​
体型 (taikei): figure; body shape; build; physique; form​
体験 (taiken): personal experience; physical experience; one’s own experience​
対抗 (taikou): opposition; antagonism​
体内 (tainai): interior of the body​
対応 (taiou): correspondence (to); equivalence​
対立 (tairitsu): suitability; coordination; matching; being appropriate (for)​
対策 (taisaku): measure; provision; step; countermeasure; counterplan; countermove​
体制 (taisei): order; system; structure; set-up; organization; organisation​
対戦 (taisen): waging war; competition​
退社 (taisha): resignation; leaving office​; leaving work (e.g. at the end of the day)​
体質 (taishitsu): constitution (physical); physical make-up; predisposition (to disease); disposition; tendency​; character (of a group, organization, etc.); innate characteristics; make-up; nature; culture​
対処 (taisho): dealing with; coping with​
退職 (taishoku): retirement; resignation​
対象外 (taishougai): not covered (by); not subject (to)​
退出 (taishutsu): leaving (e.g. work at end of day); withdrawal (e.g. from a noble’s or superior’s presence); exit (e.g. from a market)​
大敵 (taiteki): great rival; powerful enemy; archenemy​
対等 (taitou): equality (esp. of status, on equal terms); equivalence​
高まる (takamaru): to rise; to swell; to be promoted​
高め (takame): high (e.g. ball in baseball); highish; on the high side​; on the expensive side; comparatively expensive
高める (takameru): to raise; to lift; to boost; to enhance​
滝 (taki): waterfall
宅配 (takuhai): home delivery​
宅配便 (takuhaibin): express home delivery service​
逞しい (takumashii): burly; strong; sturdy; indomitable; indefatigable; strong-willed; resolute; bold
蓄える (takuwaeru): to store; to save up; to stock up on; to lay in stock; to set aside​; to accumulate (e.g. knowledge); to build up (e.g. experience); to develop (e.g. one’s skills)​
たくましい: burly; strong; sturdy; indomitable; indefatigable; strong-willed; resolute; bold​
溜める (tameru): to amass; to accumulate; to store​; to leave unpaid​
保つ (tamotsu): to keep; to preserve; to hold; to retain; to maintain; to sustain​; to last; to endure; to keep well (food); to wear well; to be durable​
多難 (tanan): full of troubles, difficulties​
単調 (tanchou): monotony; monotone; dullness​
単純明快 (tanjunmeikai): simple and clear; plain and simple
短期間 (tankikan): short term; short time​
頼もしい (tanomoshii): reliable; trustworthy​; hopeful; promising​
単身 (tanshin): alone; unaided; away from home​
短縮 (tanshuku): shortening; contraction; reduction; curtailment; abbreviation​
担当者 (tantousha): person in charge (of an area of work); person responsible; contact (person)​
たっぷり: full; in plenty; ample​
多量 (taryou): large quantity; large amount​
多彩 (tasai): variegated; varicoloured; varicolored; multi-coloured; multi-colored; diverse​
他者 (tasha): another person; others​
多種多様 (tashutayou): a great variety of; diversity​
達成 (tassei): achievement; attainment; accomplishment; realization​
達成感 (tasseikan): sense of accomplishment​
多数 (tasuu): large number (of); many​; majority
畳む (tatamu): to fold (clothes, umbrella)​; to close (a shop, business)​
立て替える (tatekaeru): to pay for another; to pay someone else’s debt as a loan to him; to make temporary payment on a person’s behalf​
頼り (tayori): reliance; dependence​
多用 (tayou): busyness; a lot of things to do​; frequent use; heavy use (of); many uses​
多様 (tayou): diverse; varied
多様化 (tayouka): diversification
多様性 (tayousei): diversity; variety​
手が空く (te ga aku/te ga suku): to be free; to be available​
手に入れる (te ni ireru): to obtain; to procure​
手に付かない (te ni tsukanai): unable to concentrate on (due to distractions, etc.)​
手足 (teashi): hands and feet; limbs​
手早い (tebayai): nimble; quick; agile​
手帳 (techou): notebook; memo pad; (pocket) diary
手書き (tegaki): handwriting; handwritten; hand-painted; hand-drawn​
手軽 (tegaru): easy; simple; informal; offhand; cheap​
手頃 (tegoro): moderate; handy; convenient; reasonable​
定着 (teichaku): sticking (in one place, position, etc.); settling; fixing; adherence​; becoming established (of a custom, system, etc.); taking hold; taking root​
庭園 (teien): garden; park​
定員 (teiin): fixed number (of people); prescribed number (of regular personnel, students, etc.); quota; numerical limit; complement​
提示 (teiji): presentation; exhibit; suggest; citation​
定価 (teika): list price; regular price; established price​
低下 (teika): fall; decline; lowering; deterioration; degradation
低価格 (teikaku): low price
低気圧 (teikiatsu): low (atmospheric) pressure; low-pressure system; depression; cyclone​; bad temper; foul mood; tense situation​
低コスト (teikosuto): low cost
抵抗感 (teikoukan): antipathy; reluctance; resistance​
提供 (teikyou): offer; tender; providing; supplying; making available; donating (blood, organs, etc.)​; sponsoring (a TV program)​
定年 (teinen): retirement age​; years of service in a military rank before eligibility for promotion
手入れ (teire): care; looking after; repair; maintenance; tending; trimming; grooming​; (police) raid; crackdown​
停止 (teishi): stoppage; coming to a stop; halt; standstill​; ceasing (movement, activity, etc.); suspension (of operations); interruption (e.g. of electricity supply); cutting off​
的確 (tekikaku): precise; accurate; appropriate; exactly the right​
適性 (tekisei): aptitude; aptness; suitability​
手元 (temoto): at hand; on hand; nearby; close at hand​; way of moving one’s arms; skill​; money at hand; pocket money​
店長 (tenchou): shop manager​
展示 (tenji): exhibition; display​
転換 (tenkan): conversion; diversion; changeover; commutation; switchover​
点検 (tenken): inspection; examination; checking​
転勤 (tenkin): job transfer; job relocation; intra-company transfer​
転校 (tenkou): changing schools​
天候不順 (tenkoufujun): unseasonable weather; fickle weather; bad weather​
転校生 (tenkousei): transfer student; student changing schools​
添付 (tenpu): attaching (documents, etc.); appending; affixing​
手作業 (tesagyou): manual labor; manual procedures​
訂正 (teisei): correction; revision; amendment​
転職 (tenshoku): change of occupation; career change​
天才 (tenzai): genius; prodigy; natural gift​
手数料 (tesuuryou): handling charge; commission​
手続き (tetsuzuki): procedure; process; proceedings; formalities​
飛び散る (tobichiru): to fly around; to scatter​
飛び回る (tobimawaru): to fly about; to skip about; to bustle about​
乏しい (toboshii): meagre; meager; scarce; limited; destitute; hard up; lacking; scanty; poor​
問い合わせ (toiawase): enquiry; inquiry; query; interrogation
問い合わせる (toiawaseru): to enquire; to inquire; to seek information​
閉じこもる (tojikomoru): to seclude oneself; to shut oneself away​
問いかける (toikakeru): to ask a question​; to begin to ask a question​
溶かす (tokasu): to dissolve​; to melt
特効薬 (tokkouyaku): specific medicine; wonder drug; silver bullet
特色 (tokushoku): characteristic; feature; idiosyncrasy; personal color​
特殊 (tokushu): special; particular; peculiar; unique
特集 (tokushuu): feature (e.g. newspaper); special edition; report​
特定 (tokutei): specific; particular; designated; special​; specifying; designating; identifying; pinpointing​
得点 (tokuten): scoring; score; points made; marks obtained; goals; runs
共働き (tomobataraki): (husband and wife) both working; dual income​
伴う (tomonau): to accompany; to go hand in hand with; to be consequent upon; to be accompanied by; to bring with; to take with; to be involved in​
遠回り (toomawari): detour; roundabout way​
取扱 (toriatsukai): treatment; service; handling; management​
取り入れる (toriireru): to harvest; to reap​; to take in; to gather in​; to adopt (e.g. idea); to accept (e.g. advice); to introduce
取り組み (torikumi): bout (in sports, etc.); match; effort; initiative; dealing with; grappling with; wrestling with​
取り込む (torikomu): to take in; to bring in; to adopt (e.g. behaviour); to introduce; to win over; to please; to curry favour with; to flatter​
取り消し (torikeshi): cancellation; withdrawal; abolition; revocation; cancel
取り組む (torikumu): to grapple with; to wrestle with; to engage in a bout; to be matched against​; to tackle (e.g. a problem); to come to grips with; to work hard on​
取り除く (torinozoku): to remove; to deinstall; to take away; to set apart​
取り付く (toritsuku): to cling to; to hold on to; to hold fast to​; to set about doing; to begin; to commence; to undertake​
取り寄せる (toriyoseru): to order; to send away for; to have (something) sent to one​
都心 (toshin): city centre (center) (esp. capital city); urban centre; heart of city a metropolis​
年取る (toshitoru): to grow old; to age​
年上 (toshiue): older; senior​
整える (totonoeru)
整う (totonou): to be ready; to be prepared; to be arranged​; to be in order; to be put in order; to be well-ordered; to be well-proportioned; to be harmonious​; to be adjusted; to be regulated; to be refined (e.g. of a face)​
取っ手 (totte): handle; grip; knob​
逃亡 (toubou): escape; flight; running away; elopement; fleeing​
当分 (toubun): for the present; for the time being​
逃避 (touhi): escape; evasion; flight​
統一 (touitsu): unity; consolidation; uniformity; unification; compatible​
登場 (toujou): entry (on stage); appearance (on screen)​; entrance; introduction (into a market)​
統計 (toukei): statistics
陶器 (touki): porcelain (esp. soft-paste porcelain); china; chinaware; earthenware; pottery; ceramics; crockery​
登校 (toukou): attendance (at school); going to school​
透明 (toumei): transparent; clear​
登録 (touroku): registration; accession; register; entry; record​
討論 (touron): debate; discussion​
到達 (toutatsu): reaching; attaining; arrival​
到底 (toutei): by no means; not at all; (cannot) possibly; utterly; absolutely​
取り上げる (toriageru): to pick up​; to adopt (e.g. a proposal); to accept; to take up (a topic, complaint, etc.); to listen to; to deal with; to feature​
取り掛かる (torikakaru): to begin; to set about; to start​
取り戻す (torimodosu): to take back; to regain; to get back; to recover​
登山家 (tozanka): mountain climber; mountaineer​
潰す (tsubusu): to smash; to crush; to flatten​; to kill (time); to while away (the time)​
呟く (tsubuyaku): to mutter; to murmur; to grumble
追加 (tsuika): addition; supplement; appending; appendix​
追求 (tsuikyuu): pursuit (of a goal, ideal, etc.); search; chase; seeking after​
追及 (tsuikyuu): investigation (e.g. into someone’s guilt); questioning; pressing; hounding; pinning down​; catching up; overtaking​
使い分ける (tsukaiwakeru): to use properly; to use (different things) for different purposes​
付け加え (tsukekuwae): addition (to something)​
付け加える (tsukekuwaeru): to add (one thing to another); to add (a few more words, an explanation, etc.)​
作り上げる (tsukuriageru): to build up; to complete; to construct; to create; to invent; to cook up​
つまずく: to stumble; to trip; to fail
積み重なる (tsumikasanaru): to pile up; to stack up; to accumulate​
積み重ねる (tsumikasaneru): to pile up; to accumulate​
積む (tsumu): to pile up; to stack​; to load (car, ship, etc.); to pack​; to acquire; to accumulate​
繋がる (tsunagaru): to be tied together; to be connected to; to be linked to​; to lead to; to be related to
努める (tsutomeru): to endeavor (endeavour); to try; to strive; to make an effort; to exert oneself; to be diligent; to be committed (to doing something)​
通知 (tsuuchi): notice; notification; report; posting​
通常 (tsuujou): usual; ordinary; normal; regular; general; common​
通路 (tsuuro): passage; pathway; roadway; avenue; aisle​
通信販売 (tsuushinhanbai): mail order; mail-order sales; shop-by-mail service; on-line shopping service (with delivery by mail)​
通用 (tsuuyou): popular use; circulation​; to pass as; to pass for​
強火 (tsuyobi): high flame (cooking); high heat; strong heat​
強気 (tsuyoki): confident; assured; self-assured; firm; strong; cocksure
強める (tsuyomeru): to strengthen; to emphasize; to emphasise​
強み (tsuyomi): forte; strong point​
打ち明ける (uchiakeru): to confide; to reveal; to disclose; to lay bare; to speak frankly; to open (one’s heart)​
打ち合わせ (uchiawase): advance arrangements; preparatory meeting; briefing session​
内側 (uchigawa): inside; interior; inner part
打ち消す (uchikesu): to deny; to contradict​; to negate (esp. a sound); to drown out​
宇宙人 (uchuujin): space alien; alien; extraterrestrial being​
動き (ugoki): movement; move; motion​; trend; development; change; fluctuation​
浮かぶ (ukabu): to float; to be suspended​; to rise to surface​; to come to mind; to have inspiration​
受け入れる (ukeireru): to accept; to receive; to agree​
受け答え (ukekotae): reply; response; answer​
埋め込む (umekomu): to bury; to embed; to implant​
有無 (umu): existence or nonexistence; presence or absence​; consent or refusal; yes or no​
運が良い (un ga yoi): lucky
促す (unagasu): to urge; to encourage; to press; to prompt; to draw (attention to)​; to stimulate (e.g. growth); to hasten (e.g. development); to quicken; to accelerate; to promote​
うなずく: to nod; to bow one’s head in assent; to agree​
運賃 (unchin): (passenger) fare​; freight rates; shipping expenses​
運営 (un’ei): management; administration; operation​
運送 (unsou): transport; freight; shipping​
占う (uranau): to tell someone’s fortune; to forecast; to predict; to divine​
売れ行き (ureyuki): sales; demand​
売り上げ (uriage): amount sold; sales; proceeds; takings; turnover​
売り切れ (urikire): sold-out​
うろうろ: restlessly; aimlessly; without purpose
薄暗い (usugurai): dim; gloomy​
薄れる (usureru): to fade; to become dim​
雨天 (uten): rainy weather​
うとうと: falling into a doze; dozing off; nodding off​
うつむく: to hang one’s head; to look down; to cast one’s eyes downward​
移し替える (utsushikaeru): to shift something to; to move something into; to transfer; to transplant; to transpose; to exchange; to displace
映る (utsuru): to be reflected; to harmonize with (harmonise); to come out (photo); to be projected; to be displayed (on a screen)​
器 (utsuwa): bowl; vessel; container​; ability; capacity; calibre; caliber​
上回る (uwamawaru): to exceed (esp. figures: profits, unemployment rate, etc.); to surpass; to be more than; to be better than
和風 (wafuu): Japanese style​
わがまま: selfish; egoist; self-indulgent; wilful; willful​
分かれる (wakareru): to separate; to split; to divide​; to disperse; to scatter​
若々しい (wakawakashii): youthful; young; young-looking​
湧く (waku): to well (up); to gush forth (of water); to spring out; to surge​; to appear (esp. suddenly) (sweat, tears, etc.)​
枠組み (wakugumi): frame; framework; outline​
割り込む (warikomu): to cut into (a line, conversation, etc.); to force oneself into (e.g. a crowd); to wedge oneself into; to squeeze oneself into; to intrude on; to interrupt​
脇道 (wakimichi): side road; byroad
悪者 (warumono): bad fellow; rascal; ruffian; scoundrel​
和食 (washoku): Japanese food; Japanese-style meal; Japanese cuisine
忘れ去る (wasuresaru): to forget completely; to leave behind​
破れる (yabureru): to get torn; to tear; to rip; to break; to wear out​; to collapse; to fall into ruin​
敗れる (yabureru): to be defeated; to be beaten; to be unsuccessful; to lose​
喧しい (yakamashii): noisy; loud; clamorous; boisterous​; much talked of; much-discussed; vexed​
夜勤 (yakin): night shift​
薬品 (yakuhin): medicine; chemicals​
役目 (yakume): duty; role; function
約束事 (yakusokugoto): promise; vow; engagement​; convention; rule; resolution​
やむを得ない (yamu o enai): cannot be helped; unavoidable​
やり甲斐 (yarigai): being worth doing
養う (yashinau): to support; to maintain; to provide for​; to bring up; to raise; to rear; to feed​; to cultivate (a habit, a quality, etc.); to develop; to build up; to foster​
安値 (yasune): low price​
屋台 (yatai): cart (esp. a food cart); stall; stand
野党 (yatou): opposition party; political opposition; opposition​
呼びかける (yobikakeru): to call out to; to hail; to address​; to appeal​
呼び止める (yobitomeru): to challenge; to call somebody to halt​
予感 (yokan): presentiment; premonition; hunch​
欲求 (yokkyuu): desire; want; will; wish; urge; craving​
欲張り (yokubari): greed; avarice; covetousness; greedy person​
欲張る (yokubaru): to covet; to lust for​
読み込む (yomikomu): to read thoroughly; to read repeatedly​; to read (extra meaning) into (something)​
読み手 (yomite): reader (person)​
読み取る (yomitoru): to read and understand; to take in​; to sense from external cues; to read (someone’s) mind​
よっぽど: very; greatly; much; to a large extent; quite
寄り道 (yorimichi): dropping in on the way; stopping off at; making a side trip​; going the long way round; making a detour​
夜型 (yorugata): nocturnal (person)​
夜遅く (yoruosoku): late at night; at a late hour​
予選 (yosen): preliminary contest; qualifying round; trial; heat; primary​
寄せる (yoseru): to come near; to let someone approach​; to bring near; to bring together; to collect; to gather​; to press; to push; to force​
予定表 (yoteihyou): schedule; program; programme; itinerary​
幼稚 (youchi): infancy; childish; infantile; immature; primitive​
幼稚園 (youchien): kindergarten
用具 (yougu): tool; implement; instrument; equipment​
用品 (youhin): articles; supplies; parts​
要因 (youin): main cause; primary factor​
要件 (youken): important matter​; requirement; requisite; necessary condition; sine qua non​
用件 (youken): business; thing to be done; something that should be performed; information that should be conveyed​
容量 (youryou): capacity; volume​
養成 (yousei): training; education; development; cultivation​
容姿 (youshi): (physical) appearance (of a person); one’s face and figure​
要旨 (youshi): point; essentials; gist; summary; fundamentals​
様式 (youshiki): style; form; pattern​
要所 (yousho): important point; important position​
要するに (you suru ni)
用途 (youto): use; service; purpose​
弱気 (yowaki): timid; weak-kneed; fainthearted​
弱まる (yowamaru): to abate; to weaken; to be emaciated; to be dejected; to be perplexed​
弱々しい (yowayowashii): frail; slender; feminine​
夜空 (yozora): night sky​
指差す (yubisasu): to point at
油断 (yudan): negligence; carelessness; inattention; unpreparedness​
行方 (yukue): (one’s) whereabouts​
緩やか (yuruyaka): loose; slack​; gentle (slope, curve); slow (speed)​
ゆったり: comfortable; easy; calm; relaxed​; loose; spacious​
有害 (yuugai): harmful; hazardous
有限 (yuugen): finite; limited​
夕日 (yuuhi): evening sun; setting sun
有意義 (yuuigi): significant; useful; meaningful; worthwhile; valuable; of interest​
有人 (yuujin): manned; occupied; piloted
有給 (yuukyuu): salaried; with pay
有力 (yuuryoku): influential; prominent​; strong; likely; plausible; potent
有力者 (yuuryokusha): influential person; man of importance​
優良 (yuuryou): superior; excellent; fine​
優先 (yuusen): preference; priority; precedence​
郵送 (yuusou): mailing; posting​
憂鬱 (yuuutsu): depression; melancholy; dejection; gloom; despondency​
在学 (zaigaku): attending (school, college, etc.); being enrolled; being a student​
在籍 (zaiseki): being enrolled (at a school); being registered; being a member (of a team, organization, etc.)​
材質 (zaishitsu): material; material properties; quality of material​
残業代 (zangyoudai): overtime pay; overtime money; overtime payment​
雑草 (zassou): weed
雑談 (zatsudan): chatting; idle talk​
ざわざわ: noisily (e.g. from many people talking); creating a commotion​; rustling (leaves)​; feeling a chill; getting the chills​
税関 (zeikan): customs; customs house​
税込 (zeikomi): tax included (e.g. price); before tax (e.g. salary)
全額 (zengaku): total; full amount; sum​
前半 (zenhan): first half​
全面 (zenmen): whole surface; entire​
全般 (zenpan): (the) whole; entirety; wholly; as a whole; generally; universally​
前回 (zenkai): previous time; last time; previous installment; previous instalment; previous session​
全面的 (zenmenteki): total; complete; all-out; general; extensive; full-scale​
全力 (zenryoku): all one’s power (strength, energy, efforts); one’s utmost​
前提 (zentei): condition; assumption; prerequisite; hypothesis​
沿い (zoi): (suffix) along
続行 (zokkou): continuation; continuance; going on; resuming​
続出 (zokushutsu): appearing one after another; cropping up one after another; occurring in succession​
属する (zokusuru): to belong to; to come under; to be affiliated with; to be subject to​
続々 (zokuzoku): successively; one after another​
存分 (zonbun): to one’s heart’s content; as much as one wants​
増大 (zoudai): enlargement; increase​
増減 (zougen): increase and decrease; fluctuation​
図表 (zuhyou): chart; diagram; graph; figure​
漬け (zuke): (suffix) pickled in (something); preserved in; dipped in​
頭脳 (zunou): head; brains​
滑らす (zurasu): to shift; to slide (e.g. something away from something else); to move (e.g. something out of the way)​; to put off; to delay; to postpone; to stagger (e.g. working hours)​
図々しい (zuuzuushii): impudent; shameless; brazen; forward; audacious; cheeky
油 (abura): oil
愛 (ai): love, affection, care
愛情 (aijou): love, affection
相変わらず (aikawarazu): as ever, as usual, the same
生憎 (ainiku): unfortunately; sorry, but…
愛する (aisuru): to love
相手 (aite): companion, partner
合図 (aizu): sign, signal
明かり (akari): light, illumination, glow
明ける (akeru): to dawn, to end (of a period, season)
空き (aki): space, room, emptiness
空き家 (akiya): vacant house, unoccupied house​
明らか (akiraka): obvious, evident, clear
諦める (akirameru): to give up, to abandon
飽きる (akiru): to get tired of
悪魔 (akuma): demon, evil
握手 (akushu): handshake
余る (amaru): to remain, to be left over
編む (amu): to knit, to braid​
案 (an): idea, plan, thought
汗 (ase): sweat, perspiration
穴 (ana): hole, deficit, vacancy
暗記 (anki): memorization
安定 (antei): stability, equilibrium
粗い (arai): coarse, rough​
嵐 (arashi): storm, tempest
新た (arata): new, fresh, novel
現れる (arawareru): to appear, to come in sight
表す (arawasu): to represent, to show, to display
有らゆる (arayuru): all, every
足元 (ashimoto): at one’s feet, under foot
与える (ataeru): to give, to bestow
値 (atai): price, cost
辺り (atari): neighborhood, nearby
当たる (ataru): to be hit, to strike
温める (atatameru): to warm, to heat​
跡 (ato): trace, tracks, mark
扱う (atsukau): to deal with, to treat
集まり (atsumari): gathering, meeting
慌てる (awateru): to panic​, to rush
誤り (ayamari): error, mistake, slip
泡 (awa): bubble, foam
哀れ (aware): pity, sorrow, grief
合わせる (awaseru): to match, to join together
預ける (azukeru): to give into custody
場 (ba): place, spot, scene
馬鹿 (baka): fool, idiot
莫大 (bakudai): enormous, vast
爆発 (bakuhatsu): explosion, detonation
場面 (bamen): scene, setting
ばらばら: scattered, in pieces
罰する (bassuru): to punish, to penalize
弁護士 (bengoshi): lawyer, attorney​
別々 (betsubetsu): separately, individually​
美人 (bijin): beautiful woman
びっくり: to be surprised
微妙 (bimyou): delicate, subtle
瓶 (bin): bottle, jar
便 (bin): mail, post, flight
ぼんやり: absentmindedly
募集 (boshuu): recruitment, taking applications​, raising (funds)
棒 (bou): pole, rod, stick
冒険 (bouken): adventure, risk
部分 (bubun): portion, section, part
部品 (buhin): parts, components​
無事 (buji): safety, peace
武器 (buki): weapon, arms
物価 (bukka): prices of commodities
文 (bun): sentence
分 (bun): part, segment, share
文明 (bunmei): civilization
分類 (bunrui): categorization, sorting​
分析 (bunseki): analysis
文章 (bunshou): essay, article, composition
分野 (bun’ya): field, sphere
ぶらぶら: strolling, wandering
無沙汰 (busata): not writing or contacting for a while
物質 (busshitsu): material, substance
舞台 (butai): stage
打つかる (butsukaru): to strike against, to collide with
物理 (butsuri): physics
秒 (byou): second
平等 (byoudou): equality, evenness
父親 (chichioya): father
知恵 (chie): wisdom, wit
違い (chigai): difference, discrepancy
地平線 (chiheisen): horizon
地方 (chihou): district, region, area
地位 (chii): social position, status
地域 (chiiki): area, region
知事 (chiji): prefectural governor
地下 (chika): basement, cellar
近頃 (chikagoro): lately, recently
近道 (chikamichi): short way, shortcut​
力強い (chikarazuyoi): powerful, strong
遅刻 (chikoku): lateness, late coming
地区 (chiku): district, section, sector
地球 (chikyuu): the earth, the globe
知能 (chinou): intelligence, brain
知識 (chishiki): knowledge, information
貯金 (chokin): savings
直接 (chokusetsu): direct, immediate
著者 (chosha): author, writer
頂上 (choujou): top, summit, peak
長期 (chouki): long-term
調査 (chousa): investigation, examination
調子 (choushi): tone, condition, health
長所 (chousho): strong point, merit, virtue
朝食 (choushoku): breakfast
中学 (chuugaku): middle school
中間 (chuukan): middle, midway, center
中古 (chuuko): used, second-hand
注目 (chuumoku): notice, attention
注文 (chuumon): order, request
駐車 (chuusha): parking
中止 (chuushi): suspension, stoppage
中心 (chuushin): center, middle, core
中心地 (chuushinchi): center, metropolis​
昼食 (chuushoku): lunch, midday meal
中央 (chuuou): centre, middle
代 (dai): cost, price​, generation
大部分 (daibubun): most part, majority
代表 (daihyou): representative
代表者 (daihyousha): representative, delegate​
大臣 (daijin): cabinet minister
代金 (daikin): price, payment, cost
代理 (dairi): representation, agency
大成功 (daiseikou): huge success​
大小 (daishou): sizes (various), large and small​
大都会 (daitokai): metropolis, big city​
大統領 (daitouryou): president, chief executive
黙る (damaru): to be silent
段 (dan): steps, stair, grade, rank
だんだん: gradually, little by little
男女 (danjo): men and women, both genders
男子 (danshi): youth, young man
団体 (dantai): organization, association
だるい: sluggish, bothersome
出会い (deai): meeting, encounter
出会う (deau): to meet (by chance)
出来事 (dekigoto): incident, affair
電池 (denchi): battery, cell​
伝言 (dengon): verbal message
電球 (denkyuu): light bulb
電子 (denshi): electron
電子レンジ (denshi renji): microwave oven
伝統 (dentou): tradition, convention
度 (do): degree, counter for occurrences​
どきどき: to beat fast (of one’s heart)
毒 (doku): poison, toxicant
独立 (dokuritsu): independence
独身 (dokushin): single, unmarried
読書 (dokusho): reading
独特 (dokutoku): peculiarity, uniqueness
泥 (doro): mud, dirt
努力 (doryoku): great effort, exertion
同一 (douitsu): identical, same
当時 (touji): at that time, in those days
同時 (douji): simultaneous, concurrent
銅貨 (douka): copper coin
どうか: please, one way or another​
同級生 (doukyuusei): classmate
道路 (douro): road, highway
同僚 (douryou): coworker, colleague
動詞 (doushi): verb
どうしても: by all means, at any cost
道徳 (doutoku): morals
同様 (douyou): identical, same
柄 (e): handle, grip
描く (egaku): to draw, to paint
笑顔 (egao): smiling face
永遠 (eien): eternity
営業 (eigyou): business, trade
影響 (eikyou): influence, effect
永久 (eikyuu): eternity
衛星 (eisei): satellite
栄養 (eiyou): nutrition, nourishment
円 (en): Japanese money unit
演技 (engi): acting, performance
援助 (enjo): assistance, aid
延期 (enki): postponement
遠足 (ensoku): excursion, outing, trip​
演奏 (ensou): musical performance
演説 (enzetsu): speech, address
得る (eru): to get, to gain, to acquire
餌 (esa): feed, bait
不安 (fuan): anxiety, uneasiness
縁 (fuchi): rim, edge, brink
普段 (fudan): usual, habitual
筆 (fude): writing brush
笛 (fue): flute, pipe
不平 (fuhei): complaint, dissatisfaction
夫人 (fujin): wife, madam
婦人 (fujin): woman, lady, adult female
不自由 (fujiyuu): discomfort, inconvenience
不可 (fuka): wrong, bad, improper
不可能 (fukanou): impossible
不幸 (fukou): unhappiness, sorrow
含む (fukumu): to contain, to comprise
袋 (fukuro): bag, sack
服装 (fukusou): garments, attire
不満 (fuman): dissatisfaction, displeasure
雰囲気 (fun’iki): atmosphere
ふらふら: unsteadily, shakily
触れる (fureru): to touch, to feel
不利 (furi): disadvantage, handicap
振る (furu): to wave, to shake
震える (furueru): to shiver, to shake
防ぐ (fusegu): to defend, to protect
不正 (fusei): injustice, unfairness
節 (fushi): joint, knuckle, tune
不思議 (fushigi): wonder, miracle, strange
不足 (fusoku): insufficiency
双子 (futago): twins
沸騰 (futtou): boiling, becoming heated
夫婦 (fuufu): married couple, spouses
風景 (fuukei): scenery, landscape
不要 (fuyou): unnecessary, unneeded
不用 (fuyou): disused, unused
不用品 (fuyouhin): disused article​
害 (gai): injury, harm, damage
外国語 (gaikokugo): foreign language​
外国産 (gaikokusan): of foreign manufacture​
外交 (gaikou): diplomacy
外食 (gaishoku): eating out, dining out​
外出 (gaishutsu): going out
画家 (gaka): painter, artist
がっかり (gakkari): feel disappointed
学期 (gakki): school term
楽器 (gakki): musical instrument​
学 (gaku): learning, scholarship
学部 (gakubu): department of a university​
学問 (gakumon): learning, study
学者 (gakusha): scholar
学習 (gakushuu): study, learning
画面 (gamen): terminal screen
柄 (gara): pattern, design
芸術 (geijutsu): art, the arts
外科 (geka): surgery, department of surgery
劇 (geki): drama, play
劇場 (gekijou): theater
現場 (genba): actual spot, scene
現代 (gendai): nowadays, modern era
言語 (gengo): language
現実 (genjitsu): reality, actuality
現状 (genjou): present condition
限界 (genkai): limit, bound
現金 (genkin): cash, ready money
現象 (genshou): phenomenon
減少 (genshou): decrease, decline
現在 (genzai): now, current
議長 (gichou): chairman
議員 (giin): member of the Diet
議会 (gikai): congress, parliament
疑問 (gimon): question, doubt
義務 (gimu): duty, obligation
銀 (gin): silver
議論 (giron): argument, discussion
技師 (gishi): engineer, technician
語 (go): language
語学 (gogaku): language study
豪華 (gouka): wonderful, gorgeous
誤解 (gokai): misunderstanding
極 (goku): quite, very
塵 (gomi): rubbish, trash
合格 (goukaku): passing (exam), success
合計 (goukei): total amount
強盗 (goutou): robber, mugger
軍 (gun): army, troop
軍隊 (guntai): armed forces
ぐっすり (gussuri): sound sleep
具体 (gutai): concrete, tangible
偶然 (guuzen): by chance, unexpectedly
逆 (gyaku): reverse, opposite
行儀 (gyougi): manners, behavior
幅 (haba): width, breadth
省く (habuku): to omit, to leave out
肌 (hada): skin
裸 (hadaka): naked, nude
派手 (hade): showy, flashy
生える (haeru): to grow, to spring up
激しい (hageshii): violent, furious
母親 (hahaoya): mother
灰 (hai): ashes
掃く (haku): to sweep, to brush
歯磨き (hamigaki): brushing one’s teeth​
配送 (haisou): delivery
配達 (haitatsu): delivery, distribution
俳優 (haiyuu): actor, actress
始まり (hajimari): origin, beginning
墓 (haka): grave, tomb
計る (hakaru): to measure, to weigh
博士 (hakase): doctorate
発見 (hakken): discovery, finding
発行 (hakkou): issue, publishing
履く (haku): to wear, to put on
吐く (haku): to vomit, to throw up
博物館 (hakubutsukan): museum
拍手 (hakushu): applause
花火 (hanabi): fireworks
離れる (hanareru): to be separated
話し合う (hanashiau): to discuss
話しかける (hanashikakeru): to start a conversation
離す (hanasu): to separate, to part
放す (hanasu): to release, to let go
花束 (hanataba): bunch of flowers, bouquet​
花屋 (hanaya): florist, flower shop​
羽 (hane): feather, down
販売 (hanbai): sales, selling
判断 (handan): judgment, decision
範囲 (han’i): range, scope, extent
反抗 (hankou): opposition, resistance
犯人 (hannin): offender, criminal
半年 (hantoshi): half year​
犯罪 (hanzai): crime, offense
発表 (happyou): announcement
腹 (hara): abdomen, stomach
原 (hara): field, plain
針 (hari): needle, pin
鋏 (hasami): scissors
破産 (hasan): bankruptcy
端 (hashi): end, edge
発車 (hassha): departure of a vehicle
発生 (hassei): outbreak, occurrence
旗 (hata): flag
畑 (hatake): field
働き (hataraki): work, labor
発達 (hattatsu): development, growth
発展 (hatten): development, growth
発売 (hatsubai): sale, launch (product)​
発明 (hatsumei): invention
早めに (hayame ni): ahead of time
外す (hazusu): to undo, to remove
塀 (hei): wall, fence
平方メートル (heihou meetoru): square meter​
平日 (heijitsu): weekday, ordinary days
平均 (heikin): average, mean
平和 (heiwa): peace, harmony
変化 (henka): change, alteration
変更 (henkou): change, modification
返却 (henkyaku): return of something, repayment​
減らす (herasu): to abate, to decrease
減る (heru): to decrease, to diminish
費 (hi): cost, expense​
冷える (hieru): to grow cold, to get chilly
被害 (higai): (suffering) damage, harm
悲劇 (higeki): tragedy
批判 (hihan): criticism, judgment
批評 (hihyou): criticism, review
非常 (hijou): emergency, extraordinary
比較 (hikaku): comparison
引き受ける (hikiukeru): to undertake, to accept
飛行 (hikou): aviation, flight
轢く (hiku): to run over (with a vehicle)
秘密 (himitsu): secret, secrecy
紐 (himo): string, cord
引っ張る (hipparu): to pull, to draw
広がる (hirogaru): to spread out, to extend
昼寝 (hirune): nap (afternoon), siesta​
必死 (hisshi): frantic, desperate
額 (hitai): forehead, brow
否定 (hitei): negation, denial
人々 (hitobito): people; men and women
人込み (hitogomi): crowd of people
一言 (hitokoto): single word, a few words
一人暮らし (hitorigurashi): living by oneself, living alone​
等しい (hitoshii): equal
費用 (hiyou): cost, expense
膝 (hiza): knee, lap
日付 (hizuke): date
略 (hobo): almost, roughly
歩道 (hodou): footpath, walkway
吠える (hoeru): to bark, to howl
微笑む (hohoemu): to smile
誇り (hokori): pride, boast
埃 (hokori): dust
歩行者 (hokousha): pedestrian, walker​
骨 (hone): bone
本気 (honki): seriousness, earnestness, truth
本物 (honmono): genuine article
本人 (honnin): the person himself
炎 (honoo): flame, blaze
本屋 (hon’ya): bookstore, bookshop​
頬 (hoo): cheek (of face)
掘る (horu): to dig, to excavate
保証 (hoshou): guarantee, security
干す (hosu): to dry, to drink up
ほっと: with a feeling of relief
保存 (hozon): preservation, conservation
方 (hou): direction, way, side
法 (hou): law, act, principle
放題 (houdai): to one’s heart’s content
豊富 (houfu): abundance, wealth
方法 (houhou): method, way, manner
報告 (houkoku): report, information
方向 (houkou): direction, way
訪問 (houmon): call, visit
宝石 (houseki): gem, jewel
放送 (housou): broadcast, broadcasting
表 (hyou): table, chart, list
評判 (hyouban): fame, reputation
表現 (hyougen): expression, representation
表情 (hyoujou): facial expression
評価 (hyouka): valuation, estimation
表面 (hyoumen): surface, face
胃 (i): stomach
一致 (icchi): match, agreement
位置 (ichi): place, position
市場 (ichiba): market, the market place
一部 (ichibu): one part, one portion
一度に (ichido ni): all at once
一時 (ichiji): time, moment
一応 (ichiou): just in case​, pretty much
一流 (ichiryuu): first-class, top grade
偉大 (idai): greatness
抱く (idaku): to embrace
移動 (idou): movement, transfer
衣服 (ifuku): clothes
意外 (igai): unexpected, surprising
違反 (ihan): violence, offense
委員 (iin): committee member
維持 (iji): maintenance, preservation
異常 (ijou): strangeness, abnormality
一家 (ikka): a house, a home
息 (iki): breath
生き物 (ikimono): living thing, animal
勢い (ikioi): force, vigor, energy
以降 (ikou): hereafter, since
居間 (ima): living room
今に (ima ni): before long, even now
今にも (ima ni mo): at any time, soon
稲 (ine): rice-plant
居眠り (inemuri): nodding off, dozing
命 (inochi): life, life force
飲料 (inryou): beverage, drink​
印刷 (insatsu): printing
飲食 (inshoku): food and drink, eating and drinking​
印象 (inshou): impression
引退 (intai): retire
引用 (in’you): quotation, citation
一般 (ippan): general, universal
一方 (ippou): one way, the other way
以来 (irai): since, henceforth
依頼 (irai): request, commission
苛々 (iraira): getting nervous, irritation
衣類 (irui): clothes, garments​
医療 (iryou): medical care
医師 (ishi): doctor, physician
意思 (ishi): intention, purpose
意志 (ishi): will, volition
意識 (ishiki): consciousness
一生 (isshou): whole life, a lifetime
一種 (isshu): species, kind
一瞬 (isshun): instant, moment
一層 (issou): much more, still more
板 (ita): board, plank
痛み (itami): pain, ache, soreness
痛む (itamu): to hurt
至る (itaru): to arrive at, to reach
悪戯 (itazura): mischief, prank
従兄弟 (itoko): cousin
一体 (ittai): what on earth…
いつの間にか (itsunomanika): before one knows
岩 (iwa): rock
言わば (iwaba): so to speak
祝う (iwau): to congratulate, to celebrate
嫌がる (iyagaru): to hate, to dislike​
以前 (izen): ago, since, before
泉 (izumi): spring, fountain
自動 (jidou): automatic
自動販売機 (jidouhanbaiki): vending machine​
自動車 (jidousha): automobile
事実 (jijitsu): fact, truth, reality
事情 (jijou): circumstances
直に (jika ni): directly, in person
事件 (jiken): event, affair, accident
時期 (jiki): time, season, period
実家 (jikka): (one’s parents’) home​
実験 (jikken): experiment
実行 (jikkou): execution, practice
時刻 (jikoku): instant, time, moment
自慢 (jiman): pride, boast
地面 (jimen): ground; earth’s surface​
事務 (jimu): business, office work
事務室 (jimushitsu): office (room)​
人物 (jinbutsu): person, character, figure
人工 (jinkou): artificial, man-made
人類 (jinrui): mankind, humanity
生 (jinsei): life
人種 (jinshu): race (of people), type of person
時差 (jisa): time difference​
自殺 (jisatsu): suicide
自身 (jishin): by oneself, personally
自信 (jishin): self-confidence
実際 (jissai): practical, reality
実施 (jisshi): enforcement, implementation
実習 (jisshuu): practice (in the field)
事態 (jitai): situation
自宅 (jitaku): one’s home, one’s house​
実現 (jitsugen): implementation
実力 (jitsuryoku): (real) ability, true strength
実は (jitsu wa): as a matter of fact
実用 (jitsuyou): practical use, utility​
徐々 (jojo): gradually, steadily
女子 (joshi): woman, girl
助手 (joshu): helper, assistant
女王 (joou): queen
丈夫 (joubu): healthy, robust, strong
冗談 (joudan): jest, joke
上下 (jouge): up and down​, top and bottom
上品 (jouhin): elegant, polished​
情報 (jouhou): information, news
条件 (jouken): conditions, terms
上空 (joukuu): sky, upper air
乗客 (joukyaku): passenger
上京 (joukyou): proceeding to the capital (Tokyo)
状況 (joukyou): state of affairs
常識 (joushiki): common sense
状態 (joutai): condition, situation
上達 (joutatsu): improvement, advance
上等 (joutou): superiority, first-class
女優 (joyuu): actress
受験 (juken): taking an examination
順 (jun): order, turn
順番 (junban): turn, order of things
順調 (junchou): favorable, doing well
銃 (juu): gun, rifle
重大 (juudai): serious, important
柔道 (juudou): judo
住民 (juumin): citizens, inhabitants
重視 (juushi): importance, stress
渋滞 (juutai): congestion, stagnation
住宅 (juutaku): residence, housing
重要 (juuyou): important, essential
需要 (juyou): demand, request
株 (kabu): stock, share
被る (kaburu): to put on (one’s head)
勝ち (kachi): win, victory
価値 (kachi): value, worth
替える (kaeru): to replace, to exchange
会 (kai): meeting, assembly
回 (kai): counter for occurrences
回復 (kaifuku): recovery
絵画 (kaiga): picture, painting
会合 (kaigou): meeting, assembly
海外 (kaigai): foreign, abroad
会員 (kaiin): member
会計 (kaikei): account, finance
改札 (kaisatsu): ticket gate, ticket barrier​
解決 (kaiketsu): settlement, solution
快晴 (kaisei): clear weather, cloudless weather
会社員 (kaishain): company employee​
解釈 (kaishaku): explanation, interpretation
開始 (kaishi): start, beginning
回収 (kaishuu): collection, retrieval
回数 (kaisuu): number of times, frequency
快適 (kaiteki): pleasant, comfortable
改善 (kaizen): improvement
化学 (kagaku): chemistry
輝く (kagayaku): to shine, to glitter
影 (kage): shadow
加減 (kagen): adjustment, degree, extent
鍵 (kagi): key
限る (kagiru): to restrict, to limit
籠 (kago): basket, cage
家具 (kagu): furniture
家事 (kaji): housework
抱える (kakaeru): to hold in the arms
価格 (kakaku): price, value, cost
かかる: to suffer from
関わる (kakawaru): to be concerned with, to have to do with
欠ける (kakeru): to be lacking
書き直す (kakinaosu): to write out, to rewrite
活気 (kakki): energy, liveliness
過去 (kako): the past, bygone days
囲む (kakomu): to surround, to encircle
各地 (kakuchi): every place, various places​
拡大 (kakudai): magnification
覚悟 (kakugo): resolution, readiness
確実 (kakujitsu): certainty, reliability
確認 (kakunin): confirmation, verification
隠れる (kakureru): to hide, to be hidden
隠す (kakusu): to hide, to conceal
我慢 (gaman): patience, endurance
構う (kamau): to mind, to care about
神 (kami): God, deity
上 (kami): person of high rank, government
雷 (kaminari): lightning, thunder
髪の毛 (kami no ke): hair (head)
科目 (kamoku): school subject
缶 (kan): can, tin
管 (kan): pipe, tube
勘 (kan): perception, intuition
看板 (kanban): signboard, billboard
必ずしも (kanarazushimo): not always
可也 (kanari): considerably, fairly
悲しむ (kanashimu): to be sad, to mourn for
感動 (kandou): feeling deeply moved emotionally
考え (kangae): thinking, thought, view
歓迎 (kangei): welcome, reception
感激 (kangeki): deep emotion, impression
患者 (kanja): patient
感じ (kanji): feeling, sense
感じる (kanjiru): to feel, to sense
勘定 (kanjou): calculation, counting
感情 (kanjou): emotion, feeling
感覚 (kankaku): sense, sensation, feeling
間隔 (kankaku): space, interval​
観光 (kankou): sightseeing
観光客 (kankoukyaku): tourist
観客 (kankyaku): audience, spectator
環境 (kankyou): environment
可能 (kanou): potential, possible
管理人 (kanrinin): administrator, manager
観察 (kansatsu): observation
感謝 (kansha): thanks, gratitude
感想 (kansou): impressions, thoughts
乾燥 (kansou): drying (e.g. clothes), dryness
香り (kaori): fragrance
空 (kara): emptiness, vacuum, blank
彼ら (karera): they (usually male)
枯れる (kareru): to wither (of a plant)
刈る (karu): to cut (hair), to mow (grass)
火災 (kasai): conflagration, fire
重ねる (kasaneru): to pile up, to heap up
稼ぐ (kasegu): to earn income
完成 (kansei): complete, completion
貸出 (kashidashi): lending, loaning
賢い (kashikoi): wise, clever, smart
感心 (kanshin): admiration
関心 (kanshin): concern, interest
関連 (kanren): relation, connection
管理 (kanri): control, management
完了 (kanryou): completion, conclusion
関する (kansuru): to concern, to be related
監督 (kantoku): supervision
歌手 (kashu): singer
型 (kata): model, type
肩 (kata): shoulder
方々 (katagata): they (people), you (plural)
片方 (katahou): one of a pair, one side
固まる (katamaru): to harden, to solidify​
刀 (katana): sword, katana
語り合う (katariau): to talk together
語る (kataru): to talk about
仮定 (katei): assumption, hypothesis
動 (katsudou): action, activity
活用 (katsuyou): practical use
勝手 (katte): one’s own convenience, selfish
飼う (kau): to keep (a pet)
皮 (kawa): skin, pelt
革 (kawa): leather
可愛らしい (kawairashii): lovely, sweet
可哀そう (kawaisou): poor, pitiable
川沿い (kawazoi): along the river, riverside
完全 (kanzen): perfection, completeness
飾り (kazari): decoration
数える (kazoeru): to count
数 (kazu): number
けち: stinginess, cheapskate
経営 (keiei): management
敬意 (keii): respect, honor
掲示 (keiji): notice, bulletin
刑事 (keji): police detective, criminal matter
掲示板 (keijiban): bulletin board, notice board
景気 (keiki): business condition
警告 (keikoku): warning, advice
傾向 (keikou): tendency, trend
計算 (keisan): calculation, reckoning
契約 (keiyaku): contract, agreement
経由 (keiyu): through, via
結果 (kekka): result, consequence
欠陥 (kekkan): defect, fault
結局 (kekkyoku): after all, eventually
煙 (kemuri): smoke, fumes
券 (ken): ticket, coupon
県 (ken): prefecture (of Japan)
建築 (kenchiku): construction, architecture
見学 (kengaku): inspection, field trip
見解 (kenkai): opinion, point of view
健康 (kenkou): health
研究者 (kenkyuusha): researcher
研究所 (kenkyuusho): research institute, laboratory​
憲法 (kenpou): constitution
権利 (kenri): right, privilege
検査 (kensa): inspection, examination
建設 (kensetsu): construction
見当 (kentou): aim, mark, direction
検討 (kentou): consideration, examination
欠席 (kesseki): absence
決心 (kesshin): determination, resolution
化粧 (keshou): make-up, cosmetics
決定 (kettei): decision, determination
欠点 (ketten): weak point, weakness
血圧 (ketsuatsu): blood pressure​
血液 (ketsueki): blood
血液型 (ketsuekigata): blood type
結論 (ketsuron): conclusion
気に入る (ki ni iru): to be pleased with
気の毒 (ki no doku): pitiful, unfortunate
希望 (kibou): hope, wish
希望者 (kibousha): applicant, candidate
きちんと (kichinto): precisely, accurately
貴重 (kichou): precious, valuable
寄付 (kifu): contribution, donation
機嫌 (kigen): humor, temper, mood
期限 (kigen): time limit, deadline
企業 (kigyou): enterprise, undertaking
基本 (kihon): foundation, basis
生地 (kiji): cloth, fabric
記事 (kiji): article, news story
機械 (kikai): machine, mechanism
期間 (kikan): period, term
機関 (kikan): engine, agency, organization
帰国 (kikoku): return to one’s country​
気候 (kikou): climate
効く (kiku): to be effective
決まり (kimari): rule, settlement
気味 (kimi): sensation, feeling
金 (kin): gold
緊張 (kinchou): tension, nervousness
近代 (kindai): present day
禁煙 (kin’en): no smoking
記念品 (kinenhin): souvenir, memento​
金額 (kingaku): amount of money
気になる (ki ni naru): to bother one, to worry about
気にする (ki ni suru): to mind, to care about
金庫 (kinko): safe, vault
筋肉 (kinniku): muscle
金銭 (kinsen): money, cash
禁止 (kinshi): prohibition, ban
金属 (kinzoku): metal
奇妙 (kimyou): strange, queer
記念 (kinen): commemoration
機能 (kinou): function
記入 (kinyuu): entry, filling in forms
金融 (kin’yuu): financing, money circulation
記憶 (kioku): memory, recollection
気温 (kion): atmospheric temperature
霧 (kiri): fog, mist
切れ (kire): piece, slide
切れる (kireru): to break, to snap
記録 (kiroku): record, document
記者 (kisha): reporter
岸 (kishi): bank, coast, shore
基礎 (kiso): foundation, basis​
期待 (kitai): expectation, hope
帰宅 (kitaku): returning home
際 (kiwa): edge, brink, verge
嫌う (kirau): to hate, to dislike
傷 (kizu): wound, injury, cut
器用 (kiyou): dexterous, skillful
気付く (kizuku): to notice, to realize
こぼす: to spill, to drop, to shed
越える (koeru): to cross over
恋 (koi): love
濃い (koi): thick, dense, strong
恋人 (koibito): lover, sweetheart
恋しい (koishii): yearned for, missed
個人 (kojin): individual, personal
国家 (kokka): state, country, nation
国会 (kokkai): National Diet, parliament
国境 (kokkyou): national border
黒板 (kokuban): blackboard
国語 (kokugo): national language
克服 (kokufuku): conquest, overcoming
国民 (kokumin): national, citizen
穀物 (kokumotsu): grain, cereal
故郷 (kokyou): home town, birthplace
呼吸 (kokyuu): breathing, respiration
小麦 (komugi): wheat
今後 (kongo): from now on
今回 (konkai): now, this time
粉 (kona): flour, powder
困難 (konnan): difficulty, distress
今日 (konnichi): this day, these days, recently
好み (konomi): liking, taste
好む (konomu): to like, to prefer
混乱 (konran): disorder, chaos
婚約 (kon’yaku): engagement, betrothal
混雑 (konzatsu): congestion, jam
氷 (koori): ice
凍る (kooru): to freeze
転ぶ (korobu): to fall down
殺す (korosu): to kill
腰 (koshi): lower back, waist
骨折 (kossetsu): bone fracture
異なる (kotonaru): to differ, to vary
断る (kotowaru): to refuse, to reject
諺 (kotowaza): proverb, maxim
好物 (koubutsu): favourite food​
行動 (koudou): action, conduct, behavior
講演 (kouen): lecture, address, speech
幸福 (koufuku): happiness
攻撃 (kougeki): attack, strike
公平 (kouhei): fairness, justice
候補 (kouho): candidate
後方 (kouhou): behind, in the rear
工事 (kouji): construction work​
効果 (kouka): effect, effectiveness
硬貨 (kouka): coin
高価 (kouka): high price
交換 (koukan): exchange, interchange
光景 (koukei): scene, spectacle
貢献 (kouken): contribution
広告 (koukoku): advertisement
航空 (koukuu): aviation, flying
公共 (koukyou): public, community
購入 (kounyuu): purchase, buy
考慮 (kouryo): consideration
交流 (kouryuu): (cultural) exchange, networking
交際 (kousai): association, friendship
構成 (kousei): organization, composition
高速 (kousoku): high speed
後者 (kousha): the latter
交通費 (koutsuuhi): traveling expenses
幸運 (kouun): good luck, fortune
小屋 (koya): hut, cabin, shed
小包 (kozutsumi): parcel, package
配る (kubaru): to distribute, to hand out
区別 (kubetsu): distinction, differentiation
工夫 (kufuu): solving ingeniously​
組 (kumi): set, group
組合 (kumiai): association, union
組み立てる (kumitateru): to assemble, to set up
曇 (kumori): cloudiness, cloudy weather
曇る (kumoru): to get cloudy
組む (kumu): to link, to put together
訓練 (kunren): practice, training
位 (kurai): rank, class, grade
暮らし (kurashi): life, living
暮らす (kurasu): to live
暮れ (kure): sunset, sundown
繰り返す (kurikaesu): to repeat
苦労 (kurou): troubles, hardships
Advertisement
苦しい (kurushii): painful, difficult
苦しむ (kurushimu): to suffer
狂う (kuruu): to go mad
臭い (kusai): stinking, smelly
鎖 (kusari): chain
腐る (kusaru): to rot, to go bad
癖 (kuse): habit
きつい (kutsui): intense, severe, hard
苦痛 (kutsuu): pain, agony
加える (kuwaeru): to add, to sum up
詳しい (kuwashii): detailed
加わる (kuwawaru): to be added to
句 (ku): sentence, passage
食う (kuu): to eat
悔しい (kuyashii): annoying, frustrating
巨大 (kyodai): huge, gigantic
許可 (kyoka): permission, approval
局 (kyoku): bureau, department
距離 (kyori): distance, range​
強調 (kyouchou): emphasis, highlight
共同 (kyoudou): doing together, joint
恐怖 (kyoufu): fear, dread, dismay
競技 (kyougi): game, match
競合 (kyougou): competition, rivalry
教授 (kyouju): professor
教科書 (kyoukasho): textbook
供給 (kyoukyuu): supply, provision
協力 (kyouryoku): cooperation
強力 (kyouryoku): powerful, strong
教師 (kyoushi): teacher (classroom)
共通 (kyoutsuu): commonness, community
共通点 (kyoutsuuten): point in common, common feature​
級 (kyuu): class (school, grade, rank
急に (kyuu ni): swiftly, rapidly
急激 (kyuugeki): sudden, radical
休日 (kyuujitsu): holiday, day off​
救助 (kyuujo): relief, aid
休暇 (kyuuka): holiday, day off
休憩 (kyuukei): rest, break, recess
給料 (kyuuryou): salary, wages
吸収 (kyuushuu): absorption
急速 (kyuusoku): rapid (progress)
眩しい (mabushii): dazzling, radiant​
間違い (machigai): mistake, error, blunder
間違う (machigau): to make a mistake
窓口 (madoguchi): ticket window, counter
孫 (mago): grandchild
迷子 (maigo): lost child, lost person
任せる (makaseru): to entrust, to leave to
負け (make): defeat, loss
幕 (maku): curtain
豆 (mame): beans
守る (mamoru): to protect, to guard
学ぶ (manabu): to study, to learn
真似 (mane): imitating, copying
招く (maneku): to invite, to ask
万一 (man’ichi): by some chance
満点 (manten): perfect score, full marks​
満足 (manzoku): satisfaction, contentment
丸 (maru): circle
真逆 (masaka): by no means, never
正に (masa ni): exactly, surely
増す (masu): to increase, to grow
回り (mawari): rotation
回す (mawasu): to turn, to rotate
迷う (mayou): to lose one’s way
先ず (mazu): first of all, to start with
混ぜる (mazeru): to mix, to stir
貧しい (mazushii): poor
命じる (meijiru): to order, to command
明確 (meikaku): clear, precise
命令 (meirei): order, command
迷惑 (meiwaku): trouble, bother, annoyance
面 (men): face, mask
綿 (men): cotton
面倒 (mendou): trouble, care
免許 (menkyo): license, permit
免許証 (menkyoshou): license, permit
面接 (mensetsu): interview (e.g. for a job)​
飯 (meshi): cooked rice, meal
目覚まし時計 (mezamashidokei): alarm clock​
身 (mi): body, oneself
実 (mi): fruit, nut
身につける (mi ni tsukeru): to learn; to acquire knowledge​
満ちる (michiru): to be full
身近 (midjika): near oneself, close to one
見事 (migoto): splendid, magnificent
味方 (mikata): friend, ally
見舞い (mimai): visiting ill or distressed people
未満 (miman): less than, insufficient​
見送り (miokuri): seeing one off
見送る (miokuru): to see someone off
未来 (mirai): the future
魅力 (miryoku): charm, fascination
認める (mitomeru): to accept, to admit
見つめる (mitsumeru): to stare at, to gaze at
土産 (miyage): present, souvenir
都 (miyako): capital, metropolis
持上げる (mochiageru): to elevate, to raise
持ち運び (mochihakobi): carrying
用いる (mochiiru): to use, to make use of
持ち物 (mochimono): personal effects, one’s belongings​
戻す (modosu): to put back, to give back
燃える (moeru): to burn, to get fired up
文字 (moji): letter (of alphabet)
目標 (mokuhyou): objective, target
目的 (mokuteki): goal, purpose, aim
文句 (monku): complaint, grumbling
者 (mono): person
物語 (monogatari): tale, story
物事 (monogoto): things, everything
物音 (monooto): sounds
盛り (mori): serving, helping
元 (moto): origin, source, base
求める (motomeru): to want, to wish for
最も (mottomo): most, extremely
毛布 (moufu): blanket
申し込み (moushikomi): application, entry
申込書 (moushikomisho): application form
申し込む (moushikomu): to apply for
申し訳 (moushiwake): apology, excuse
模様 (moyou): pattern, design
夢中 (muchuu): daze, ecstasy
無駄 (muda): futility, uselessness
迎え (mukae): meeting, greeting
向かい (mukai): facing, opposite
向ける (mukeru): to turn toward, to point
向く (muku): to face, to turn toward
剥く (muku): to peel, to skin
胸 (mune): chest, breast
無料 (muryou): free, no charge
無視 (mushi): disregarding, ignoring
虫歯 (mushiba): cavity, tooth decay
結ぶ (musubu): to tie, to bind
妙 (myou): strange, unusual
名 (na): name, given name
鍋 (nabe): saucepan, pot
撫でる (naderu): to stroke, to caress
長生き (nagaiki): longevity, long life​
眺め (nagame): view, scene, prospect
眺める (nagameru): to view, to gaze at
流れ (nagare): stream, current, flow
流れる (nagareru): to stream, to flow
流す (nagasu): to drain, to shed
慰める (nagusameru): to comfort, to console
内緒 (naisho): secrecy, confidentiality
内容 (naiyou): contents, matter
仲 (naka): relation, relationship
半ば (nakaba): middle, half
仲間 (nakama): fellow, companion
中身 (nakami): contents, interior
仲直り (nakanaori): reconciliation, make peace with​
生 (nama): raw, uncooked
怠ける (namakeru): to be idle
波 (nami): wave
涙 (namida): tears
直 (nao): straight, ordinary, common
情けない (nasakenai): miserable, pitiable
納得 (nattoku): consent, assent
懐かしい (natsukashii): missed, nostalgic​
縄 (nawa): rope, cord
悩む (nayamu): to be worried
謎 (nazo): riddle, puzzle, mystery
根 (ne): root, source, origin
熱中 (necchuu): going nuts (over something)
値段 (nedan): price, cost
願い (negai): desire, wish
願う (negau): to desire, to wish
年代 (nendai): age, era, period
年中 (nenjuu): whole year, all year round
年間 (nenkan): years (period of)
年齢 (nenrei): age, years
熱帯 (nettai): tropics
鼠 (nezumi): mouse, rat
似合う (niau): to suit, to match
日常 (nichijou): ordinary, everyday
日中 (nicchuu): daytime, during the day
日時 (nichiji): date and time​
日夜 (nichiya): day and night, always, constantly
苦手 (nigate): poor at, weak in
握る (nigiru): to grip, to grasp
日本 (nihon): Japan
日光 (nikkou): sunlight
にっこり (nikkori): smile, grin
人間 (ningen): human being, person
人気 (ninki): popularity
人数 (ninzuu): the number of people​
日程 (nittei): schedule, program
野 (no): plain, field
伸ばす (nobasu): to grow long
述べる (noberu): to state, to express
伸びる (nobiru): to stretch, to extend
軒 (noki): eaves
残り (nokori): remnant, residue
残す (nokosu): to leave (behind)
のんびり (nonbiri): carefree, at leisure
乗せる (noseru): to place on
能 (nou): talent, gift, function
農業 (nougyou): agriculture
農家 (nouka): farmer, farm family
農民 (noumin): farmers, peasants
能力 (nouryoku): ability
除く (nozoku): to exclude, to except
望み (nozomi): hope, desire, wish
望む (nozomu): to desire, to wish for
抜ける (nukeru): to come out, to fall out
抜く (nuku): to extract, to omit
布 (nuno): cloth
入学 (nyuugaku): matriculation
入院 (nyuuin): hospitalization
入場 (nyuujou): entrance, admission
入力 (nyuuryoku): input, (data) entry​
入社 (nyuusha): joining a company
溺れる (oboreru): to drown
帯 (obi): obi, kimono sash
落ち着く (ochitsuku): to calm down, to compose oneself
穏やか (odayaka): calm, gentle, quiet
終える (oeru): to finish
老い (oi): old age, old person
お辞儀 (ojigi): bow, bowing
丘 (oka): hill, height
沖 (oki): open sea
起こる (okoru): to occur, to happen
奥 (oku): inner part
贈る (okuru): to give (as a gift)
主に (omo ni): mainly, primarily
思い出 (omoide): memories
思わず (omowazu): unintentionally
おむつ: diaper, nappy
恩 (on): favor, debt of gratitude
温暖 (ondan): warm, mild
温度 (ondo): temperature
鬼 (oni): demon
温泉 (onsen): hot spring​
追い付く (oitsuku): to catch up with
大雨 (ooame): heavy rain​
大型 (oogata): large, larged-size
大いに (ooi ni): very, much, greatly
覆う (oou): to cover, to conceal
大家 (ooya): landlord, landlady
大雪 (ooyuki): heavy snow​
下す (orosu): to lower, to drop
降ろす (orosu): to take down, to unload
収める (osameru): to dedicate, to supply
幼い (osanai): very young, childish
抑える (osaeru): to restrain, to control
汚染 (osen): pollution, contamination
お喋り (oshaberi): chattering, talk
おしまい: the end, closing
おすすめ: recommendation, suggestion
劣る (otoru): to be inferior to
恐らく (osoraku): perhaps, likely
恐れる (osoreru): to fear, to be afraid of
恐ろしい (osoroshii): terrible, dreadful
お互い (otagai): mutual
おとなしい: obedient, docile, quiet​
追う (ou): to chase, to run after
応募 (oubo): application, enlistment
応援 (ouen): aid, assistance, help
往復 (oufuku): making a round trip
王/王様 (ou/ousama): king, ruler
横断 (oudan): crossing, traverse
王子 (ouji): prince
応じる (oujiru): to respond, to comply
応用 (ouyou): putting to practical use​
終 (owari): the end
及ぼす (oyobosu): to exert, to cause
泳ぎ (oyogi): swimming
凡そ (oyoso): about, roughly
ぺらぺら: fluently
ぴったり (pittari): exactly, tightly
楽 (raku): comfort, ease
例 (rei): example, case
礼儀 (reigi): manners, courtesy
冷静 (reisei): calm, composure
連絡先 (renrakusaki): contact address​
練習 (renshuu): practice, practicing
連想 (rensou): association of ideas
連続 (renzoku): serial, consecutive
列車 (ressha): train (ordinary)
列 (retsu): queue, line
利益 (rieki): profit, gains
理解 (rikai): understanding, comprehension
離婚 (rikon): divorce
利口 (rikou): clever, intelligent
立派 (rippa): splendid, fine
理想 (risou): ideal
率 (ritsu): rate, ratio
利用者 (riyousha): user, consumer​
論文 (ronbun): thesis, essay
論じる (ronjiru): to argue, to debate
論争 (ronsou): controversy, dispute
労働 (roudou): manual labor, work
老人 (roujin): the aged, old person
量 (ryou): quantity, amount
両替 (ryougae): change, money exchange
料金 (ryoukin): fee, charge, fare
領収書 (ryoushuusho): hand-written receipt​
留学 (ryuugaku): studying abroad
流行 (ryuukou): fashion, vogue
差 (sa): difference, variation
砂漠 (sabaku): desert
差別 (sabetsu): discrimination
作業 (sagyou): work, operation
作法 (sahou): manners, etiquette
裁判 (saiban): trial, judgement
最上 (saijou): best
参加者 (sankasha): participant, entrant​
最高 (saikou): highest, supreme
才能 (sainou): talent, ability
最終 (saishuu): last, final
最低 (saitei): least, lowest, worst
幸い (saiwai): happiness, luckily
境 (sakai): border, boundery
逆らう (sakarau): to go against, to oppose
盛り (sakari): peak, height
叫ぶ (sakebu): to shout, to cry
避ける (sakeru): to avoid, to ward off
作家 (sakka): author, writer
作曲 (sakkyoku): composition
作品 (sakuhin): work, production
作物 (sakumotsu): produce, crops
桜 (sakura): cherry blossom
覚ます (samasu): to awaken
覚める (sameru): to wake up
様々 (samazama): varied, various
参加 (sanka): participation
参考 (sankou): reference, consultation
賛成 (sansei): approval, agreement
酸素 (sanso): oxygen
さっぱり (sappari): feeling refreshed
更に (sara ni): furthermore, again
去る (saru): to leave, to go away
猿 (saru): monkey
支える (sasaeru): to support, to prop
誘う (sasou): to invite, to call for
指す (sasu): to point, to indicate
さっそく: at once, immediately
偖 (sate): well, now, then
札 (satsu): note, paper money
騒ぎ (sawagi): uproar, disturbance
左右 (sayuu): left and right, control
正 (sei): true, regular
性 (sei): gender
所為 (sei): consequence, result, blame
製 (sei): -made, make​
性別 (seibetsu): gender
生物 (seibutsu): living things
成長 (seichou): growth, grow to adulthood
制度 (seido): system, institution
政府 (seifu): government, administration
制服 (seifuku): uniform
制限 (seigen): restriction, restraint
製品 (seihin): manufactured goods
政治家 (seijika): politician, statesman​
成人 (seijin): adult
正常 (seijou): normalcy, normality
正解 (seikai): correct, right
性格 (seikaku): character, personality
正確 (seikaku): accurate, punctual
清潔 (seiketsu): clean, sanitary
世紀 (seiki): century, era
成功 (seikou): success, hit
請求 (seikyuu): claim, demand, charge
生命 (seimei): life, existence
青年 (seinen): youth, young man
整理 (seiri): sorting, arrangement
生産 (seisan): production, manufacture
成績 (seiseki): results, grade
正式 (seishiki): official, formality
精神 (seishin): spirit, heart, mind
精々 (seizei): at the most, at best
製造 (seizou): manufacture, production
世間 (seken): world, society
咳 (seki): cough
責任 (sekinin): duty, responsibility
石炭 (sekitan): coal
石油 (sekiyu): oil, petroleum
せっかく: with trouble, at great pains
設計 (sekkei): plan, design, layout
積極的 (sekkyokuteki): assertive, positive
責める (semeru): to blame, to condemn
宣伝 (senden): publicity, advertisement
先日 (senjitsu): the other day
専攻 (senkou): major subject
専門 (senmon): specialty, area of expertise​
専門家 (senmonka): specialist, expert
選手 (senshu): player, team member
選択 (sentaku): selection, choice
説 (setsu): theory
設備 (setsubi): equipment, device
説明会 (setsumeikai): information session, briefing
節約 (setsuyaku): economizing, saving
喋る (shaberu): to talk, to chat
車道 (shadou): roadway
社員 (shain): company employee​
借金 (shakkin): debt, loan, liabilities
詩 (shi): poem
幸せ (shiawase): happiness, good fortune
芝居 (shibai): play, drama
芝生 (shibafu): lawn
縛る (shibaru): to tie, to bind, to fasten​
屡々 (shibashiba): often, again and again
死亡 (shibou): death, mortality
次第に (shidai ni): gradually, in sequence
指導 (shidou): leadership, guidance
指導者 (shidousha): leader, guide
刺激 (shigeki): stimulus, impetus
資源 (shigen): resources
支配 (shihai): domination, rule
支払い (shiharai): payment
支払う (shiharau): to pay
始発 (shihatsu): first train, first bus
資本 (shihon): funds, capital
詩人 (shijin): poet
然も (shika mo): moreover, furthermore
式 (shiki): equation, ceremony, style
頻りに (shikiri ni): frequently, repeatedly
湿気 (shikke): moisture, humidity, dampness​
支給 (shikyuu): provision, supply
姉妹 (shimai): sisters
仕舞う (shimau): to finish, to stop
締め切り (shimekiri): deadline, closing
占める (shimeru): to occupy, to hold
締める (shimeru): to tie, to fasten, to tighten
示す (shimesu): to show, to indicate
霜 (shimo): frost
品 (shina): article, item, goods
身長 (shinchou): height (of body), stature
慎重 (shinchou): careful, cautious, prudent
進学 (shingaku): entering a higher-level school
信号 (shingou): signal, traffic light
信じる (shinjiru): to believe, to trust
新幹線 (shinkansen): Shinkansen, bullet train​
神経 (shinkei): nerve, sensitivity
真剣 (shinken): seriousness, earnestness
深刻 (shinkoku): serious, severe
信仰 (shinkou): faith, belief
信念 (shinnen): belief, faith, conviction
新入生 (shinnyuusei): new student, freshman
審判 (shinpan): refereeing, trial
進歩 (shinpo): progress, advance
信頼 (shinrai): reliance, trust
心理 (shinri): state of mind, mentality
森林 (shinrin): forest, woods​
診察 (shinsatsu): medical examination
親戚 (shinseki): relative, relation
新鮮 (shinsen): fresh
信用 (shin’you): confidence, credit
親友 (shin’yuu): close friend
心臓 (shinzou): heart, guts, nerve
調べ物 (shirabemono): matter to be checked or investigated​
知らせ (shirase): news, notice
尻 (shiri): buttocks, bottom
知り合い (shiriai): acquaintance
知り合う (shiriau): to get to know (someone)
城 (shiro): castle
印 (shirushi): seal, stamp, mark
資料 (shiryou): materials, data, document​
姿勢 (shisei): posture, attitude
試食 (shishoku): sampling food​
支出 (shishutsu): expenditure
思想 (shisou): thought, idea
舌 (shita): tongue
従う (shitagau): to abide (by the rules)
親しい (shitashii): intimate, close
指定 (shitei): assignment, appointment
支店 (shiten): branch office
質 (shitsu): quality, value
失望 (shitsubou): disappointment, despair
湿度 (shitsudo): level of humidity​
失業 (shitsugyou): unemployment
しつこい: obstinate, persistent
室内 (shitsunai): indoor, inside the room​
市役所 (shiyakusho): municipal office, city hall​
使用 (shiyou): use, application
自然 (shizen): nature, natural
沈む (shizumu): to sink, to go under
食器 (shokki): tableware
職 (shoku): job, work, employment
職場 (shokuba): place of work, workplace
植物 (shokubutsu): plant, vegetation
職業 (shokugyou): occupation, business
食品 (shokuhin): food, foodstuff
食物 (shokumotsu): food, foodstuff
食卓 (shokutaku): dining table
食欲 (shokuyoku): appetite (for food)
食料 (shokuryou): food
食糧 (shokuryou): provisions, food supply
署名 (shomei): signature
書物 (shomotsu): books
処理 (shori): processing, dealing with
書類 (shorui): documents, official papers
書斎 (shosai): study, library
章 (shou): chapter, section
賞 (shou): prize, award
商売 (shoubai): trade, business
消防 (shoubou): fire fighting
承知 (shouchi): knowledge, awareness
障害 (shougai): obstacle, impediment
奨学金 (shougakukin): scholarship
小学生 (shougakusei): primary school student
正午 (shougo): noon, midday
消費 (shouhi): consumption, expenditure
商品 (shouhin): commodity, goods
正直 (shoujiki): honesty, integrity
生じる (shoujiru): to produce, to yield
少女 (shoujo): little girl, young lady
症状 (shoujou): symptoms, condition
証明 (shoumei): proof, verification
少年 (shounen): boy, juvenile
商人 (shounin): trader, merchant
承認 (shounin): recognition, acknowledgement
小説家 (shousetsuka): novelist, fiction writer​
少々 (shoushou): just a minute
衝突 (shoutotsu): collision, crash
出張 (shucchou): official tour, business trip
主張 (shuchou): claim, insistence
手段 (shudan): means, way, measure
主婦 (shufu): housewife, mistress
主義 (shugi): principle, rule, doctrine
手術 (shujutsu): surgical operation
瞬間 (shunkan): moment, instant, second
出勤 (shukkin): going to work, leaving for work
縮小 (shukushou): reduction, curtailment​
種類 (shurui): variety, kind, type
首相 (shushou): Prime Minister
首都 (shuto): capital city
宿泊 (shukuhaku): lodging
出版 (shuppan): publication
主要 (shuyou): chief, main, principle
出身 (shusshin): person’s origin
集中 (shuuchuu): concentration
集団 (shuudan): group, mass
集合 (shuugou): gathering, assembly, meeting​
周囲 (shuui): surroundings, environs
収穫 (shuukaku): harvest, crop
週間 (shuukan): week
週刊 (shuukan): weekly publication​
宗教 (shuukyou): religion
週末 (shuumatsu): weekend
収入 (shuunyuu): income, revenue
修理 (shuuri): repairing, mending
終了 (shuuryou): end, close, termination​
修正 (shuusei): amendment, correction
就職 (shuushoku): finding employment
終点 (shuuten): terminus, last stop (e.g. train)​
育つ (sodatsu): to be raised
袖 (sode): sleeve
祖父母 (sofubo): grandparents
底 (soko): bottom, sole
速度 (sokudo): speed, velocity
そっくり (sokkuri): all, together, just like
粗末 (somatsu): rude, rough, plain
損 (son): loss, disadvantage
備える (sonaeru): to furnish, to provide for
尊重 (sonchou): respect, esteem
損害 (songai): damage, injury, loss
尊敬 (sonkei): respect, esteem
存在 (sonzai): existence, being
夫々 (sorezore): each, respectively​
注ぐ (sosogu): to pour into, to fill
組織 (soshiki): organization
装置 (souchi): equipment, installation
早朝 (souchou): early morning
掃除機 (soujiki): vacuum cleaner​
騒音 (souon): noise
操作 (sousa): operation, management
早退 (soutai): leaving early​
相当 (soutou): considerable, suitable
相続 (souzoku): succession, inheritance
想像 (souzou): imagination, guess
そっと: secretly, gently
巣 (su): nest, hive
全て (subete): everything, all
末 (sue): tip, top, end, close
姿 (sugata): figure, form, shape
筋 (suji): muscle
過ごす (sugosu): to pass (time)
優れる (sugureru): to surpass, to excel
水準 (suijun): level, standard
睡眠 (suimin): sleep
推薦 (suisen): recommendation, referral
救う (sukuu): to rescue from
済ませる (sumaseru): to finish
鋭い (surudoi): sharp, pointed
進める (susumeru): to advance, to promote
勧める (susumeru): to recommend
素敵 (suteki): lovely, beautiful
数字 (suuji): numeral, figure, digit
束 (taba): bundle, bunch
旅 (tabi): travel, trip, journey
度々 (tabitabi): often, again and again
多分 (tabun): perhaps, probably
立場 (tachiba): standpoint, position
立上る (tachiagaru): to stand up
唯 (tada): ordinary, free of charge
直ちに (tadachi ni): at once, immediately
互い (tagai): mutual, reciprocal
態度 (taido): attitude, manner
大半 (taihan): majority, more than half
逮捕 (taiho): arrest, apprehension
体育 (taiiku): physical education
体育館 (taiikukan): gymnasium
体重 (taijuu): (body) weight​
大会 (taikai): convention, tournament
大気 (taiki): atmosphere
退屈 (taikutsu): tedium, boredom
体温 (taion): body temperature
平ら (taira): flatness, level
大陸 (tairiku): continent
体力 (tairyoku): physical strength, stamina
大量 (tairyou): large quantity, mass
大戦 (taisen): great war, great battle
大使 (taishi): ambassador
大した (taishita): considerable, great
対象 (taishou): target, object
体操 (taisou): gymnastics, physical exercises
対する (tai suru): to face (each other)
大抵 (taitei): mostly, usually
太陽 (taiyou): sun, solar
滞在 (taizai): staying, sojourn
宝 (takara): treasure
弾 (tama): ball, sphere, globe, bullet
貯まる (tamaru): to be saved up (of money)​
偶々 (tamatama): casually, unexpectedly
貯める (tameru): to save up (money)
試し (tameshi): trial, test
試す (tamesu): to try out, to test
種 (tane): seed, kind, variety
単語 (tango): word, vocabulary
谷 (tani): valley
単位 (tan’i): unit, denomination
短気 (tanki): quick temper, short temper​
他人 (ta’nin): another person, others
単なる (tannaru): mere, simple, sheer
単に (tan ni): simply, merely
誕生 (tanjou): birth, creation
単純 (tanjun): simplicity, simple
楽しむ (tanoshimu): to enjoy (oneself)​
担当 (tantou): being in charge
倒す (taosu): to bring down
確かめる (tashikameru): to ascertain, to check
多少 (tashou): more or less, somewhat
達する (tassuru): to reach, to get to
助ける (tasukeru): to save, to rescue
戦い (tatakai): battle, fight
戦う (tatakau): to fight, to struggle
叩く (tataku): to strike, to beat
縦 (tate): the vertical, height
立て直す (tatenaosu): to restore, to revive
経つ (tatsu): to pass, to lapse
便り (tayori): news, tidings
頼る (tayoru): to rely on
提案 (teian): proposal, suggestion
停電 (teiden): power outage, blackout
程度 (teido): degree, amount
定期 (teiki): fixed period, fixed term
抵抗 (teikou): resistance, opposition
停留所 (teiryuujou): bus stop, tram stop
停車 (teisha): stopping (of a train, car, etc.)
定食 (teishoku): set meal
提出 (teishutsu): to present, to submit
手品 (tejina): sleight of hand, magic
敵 (teki): opponent, rival
適する (teki suru): to fit, to suit
適度 (tekido): moderate
適切 (tekisetsu): adequate, appropriate
適用 (tekiyou): applying, adoption
手間 (tema): time, labor
典型 (tenkei): pattern, model
天候 (tenkou): weather
店内 (tennai): store interior​
天然 (tennen): nature, spontaneity
徹底 (tettei): thoroughness, completeness
鉄 (tetsu): iron
手伝い (tetsudai): assistant, help
鉄道 (tetsudou): railroad, railway
哲学 (tetsugaku): philosophy
徹夜 (tetsuya): all night
飛ばす (tobasu): to fly, to skip over
土地 (tochi): plot of land, soil
届く (todoku): to reach, to be delivered
徒歩 (toho): walking, going on foot​
問い (toi): question, query
閉じる (tojiru): to close (book, eyes)
都会 (tokai): city
解ける (tokeru): to be solved, to loosen
時 (toki): time, hour, moment, occasion
解く (toku): to untie, to solve
特徴 (tokuchou): feature, trait
得意 (tokui): one’s strong point, frequent customer
留める (tomaru): to stop, to turn off
友 (tomo): friend, companion
兎に角 (tonikaku): anyhow, at any rate
とんでも無い (tondemonai): unthinkable
通り (toori): avenue, street
通り過ぎる (toorisugiru): to pass through
通す (toosu): to force through, to let pass
虎 (tora): tiger
取れる (toreru): to come off, to be removed
取上げる (toriageru): to take up, to pick up
都市 (toshi): town, city
年月 (toshitsuki): months and years
年寄 (toshiyori): old people, the aged
図書 (tosho): books
突然 (totsuzen): abrupt, sudden
党 (tou): party (political)
塔 (tou): tower, pagoda
答案 (touan): examination paper
到着 (touchaku): arrival
投票 (touhyou): voting, poll
当日 (toujitsu): appointed day, very day​
当然 (touzen): natural
登山 (tozan): mountain climbing
翼 (tsubasa): wing
土 (tsuchi): earth, soil, dirt
次々 (tsugitsugi): in succession, one by one
遂に (tsui ni): finally, at last
捕まる (tsukamaru): to be caught
掴む (tsukamu): to seize, to catch
疲れ (tsukare): tiredness, fatigue
付合い (tsukiai): association, socializing
付き合う (tsukiau): to associate with, to go out with
就く (tsuku): to take (seat, position)
詰める (tsumeru): to stuff into, to jam
罪 (tsumi): crime, sin, wrongdoing
積もる (tsumoru): to pile up, to accumulate
繋ぐ (tsunagu): to connect, to link together
常に (tsune ni): always, constantly
角 (tsuno): horn
辛い (tsurai): painful, bitter
連れ (tsure): companion, company
釣 (tsuri): fishing, angling
伝わる (tsutawaru): to be transmitted
勤め (tsutome): service, duty, business
包み (tsutsumi): bundle, package, parcel
通知 (tsuuchi): notice, notification
通学 (tsuugaku): commuting to school
通じる (tsuujiru): to lead to, to be understood
通過 (tsuuka): passage through
通勤 (tsuukin): commuting to work​
通行 (tsuukou): passage, passing
通信 (tsuushin): correspondence, communication
通訳 (tsuuyaku): interpretation
梅雨 (tsuyu): rainy season
続き (tsuzuki): sequel, continuation
奪う (ubau): to snatch away
宇宙 (uchuu): universe, cosmos
動かす (ugokasu): to move, to shift
伺う (ukagau): to ask, to inquire
受け取る (uketoru): to receive, to get
うっかり: carelessly, thoughtlessly
浮く (uku): to float​
馬 (uma): horse
生まれ (umare): birth, birthplace
梅 (ume): plum, plum tree
埋める (umeru): to bury, to fill up
生む: to give birth, to produce
運 (un): fortune, luck
唸る (unaru): to groan, to moan
運動会 (undoukai): athletic meet, sports day​
裏側 (uragawa): the reverse, other side
羨ましい (urayamashii): envious, jealous
裏切る (uragiru): to betray
売れる (ureru): to sell well
売り切れる (urikireru): to be sold out​
兎 (usagi): rabbit, hare
牛 (ushi): cattle, cow
失う (ushinau): to lose
疑う (utagau): to doubt, to distrust
撃つ (utsu): to shoot, to attack
移す (utsusu): to transfer, to move
訴える (uttaeru): to appeal, to sue
噂 (uwasa): rumor, gossip
輪 (wa): ring, circle, loop
話題 (wadai): topic, subject
我が家 (wagaya): one’s house, one’s home
若者 (wakamono): young people
別れ (wakare): parting, separation
訳 (wake): reason, cause, meaning
分ける (wakeru): to divide
脇 (waki): beside, close to, nearby
湾 (wan): bay, gulf
笑い (warai): laugh, laughter
我々 (wareware): we
割 (wari): rate, ratio, proportion
割引 (waribiki): discount, reduction
割る (waru): to divide, to cut
悪口 (warukuchi): bad mouth, insult
僅か (wazuka): only, merely
破る (yaburu): to tear, to break
家賃 (yachin): rent
宿 (yado): inn, lodging
矢張り (yahari): as expected
夜間 (yakan): night, nighttime​
厄介 (yakkai): trouble, nuisance
役 (yaku): use, service, role
約 (yaku): approximately, about
役立つ (yakudatsu): to be useful, to be helpful
役割 (yakuwari): part, role, duties
野球 (yakyuu): baseball
山登り (yamanobori): mountain climbing
辞める (yameru): to retire, to resign
屋根 (yane): roof
やり直す (yarinaosu): to do over again, to redo
雇う (yatou): to employ, to hire
夜明け (yoake): dawn, daybreak
予防 (yobou): prevention, precaution
余分 (yobun): extra, excess
汚れ (yogore): dirt, filth, stain
予報 (yohou): forecast, prediction
予期 (yoki): expectation, forecast
横切る (yokogiru): to cross, to traverse
横 (yoko): horizontal, beside
翌朝 (yokuasa): next morning​
翌年 (yokutoshi): following year​
嫁 (yome): wife, bride
読み (yomi): reading
夜中 (yonaka): midnight, dead of night
世の中 (yo no naka): world, society
喜び (yorokobi): joy, delight
予算 (yosan): estimate, budget
予測 (yosoku): prediction, estimation
予想 (yosou): expectation, prediction
予想外 (yosougai): unexpected, unforeseen
止す (yosu): to cease, to desist
酔う (you): to get drunk
容易 (youi): easy, simple, plain
容器 (youki): container, vessel
用心 (youjin): care, precaution
陽気 (youki): weather, cheerful
要求 (youkyuu): demand, firm request
用紙 (youshi): blank form​
要素 (youso): element, factor, component
様子 (yousu): state, appearance
要点 (youten): gist, main point
ようやく: finally, at last
余裕 (yoyuu): surplus, margin
唯一 (yuiitsu): only, sole, unique
ゆるい: loose
床 (yuka): floor
愉快 (yukai): pleasant, happy
行き (yuki): bound for, going to
行き先 (yukisaki): destination, whereabouts
許す (yurusu): to permit, to allow
豊か (yutaka): abundant, wealthy
郵便 (yuubin): mail service
遊園地 (yuuenchi): amusement park
夕方 (yuugata): evening, dusk​
友人 (yuujin): friend
友情 (yuujou): friendship, fellowship
勇気 (yuuki): courage, bravery
有効 (yuukou): validity, effectiveness
友好 (yuukou): friendship
有能 (yuunou): capable, efficient
有利 (yuuri): advantageous, profitable
有料 (yuuryou): fee-charging, paid
優勝 (yuushou): championship, overall victory
優秀 (yuushuu): superiority, excellence
郵送 (yuusou): mailing, posting​
譲る (yuzuru): to hand over, to surrender
稍 (yaya): a little, partially
材料 (zairyou): ingredients, material
財産 (zaisan): property, fortune, assets
残業 (zangyou): overtime (work)​
座席 (zaseki): seat
ざっと (zatto): roughly, in rough number
是非 (zehi): certainly, without fail
税金 (zeikin): tax, duty
贅沢 (zeitaku): luxury, extravagance
善 (zen): good, goodness, virtue
前後 (zengo): before and after​, front and rear
全員 (zen’in): all members, everyone
前日 (zenjitsu): previous day, day before
全国 (zenkoku): countrywide, nationwide
前者 (zensha): the former
前進 (zenshin): advance, drive, progress
全身 (zenshin): whole (body), full-length
全体 (zentai): whole, entirety
絶対 (zettai): absolutely
絶滅 (zetsumetsu): destruction, exinction
象 (zou): elephant
増加 (zouka): increase
図 (zu): drawing, picture, diagram
随分 (zuibun): very, extremely
ずっと (zutto): continuously in some state
頭痛 (zutsuu): headache
上がる (agaru): to rise, to ascend
挨拶 (aisatsu): greeting, salutation
味 (aji): flavor, taste
赤ちゃん (akachan): baby, infant​
赤ん坊 (akanbou): baby, infant​
案内 (annai): guidance, leading (the way)
安心 (anshin): relief, peace of mind​
安全 (anzen): safety
浅い (asai): shallow, superficial​
足音 (ashioto): sound of footsteps
遊び (asobi): playing
集る (atsumaru): to gather, to collect, to assemble​
集める (atsumeru): to collect, to assemble, to gather​
合う (au): to fit, to match, to suit
謝る (ayamaru): to apologize
倍 (bai): twice, double​, times
番組 (bangumi): program (e.g. TV)
場所 (basho): place, location
別 (betsu): different, another
美術館 (bijutsukan): art gallery, art museum​
びっくり (bikkuri): to be surprised
僕 (boku): I, me
貿易 (boueki): trade (foreign)​
部長 (buchou): head of a section or department
ぶどう (budou): grape
文学 (bungaku): literature
文化 (bunka): culture, civilization
文法 (bunpou): grammar
血 (chi): blood
力 (chikara): force, strength, vigor
地理 (chiri): geography
中学校 (chuugakkou): junior high school
注意 (chuui): caution, being careful
注射 (chuusha): injection
駐車場 (chuushajou): parking lot
大分 (daibu): considerably, greatly
大学生 (daigakusei): university student
大事 (daiji): important, serious, crucial​
大体 (daitai): general, substantially
だから (dakara): so, therefore
駄目 (dame): no good, useless
暖房 (danbou): (indoor) heating​
男性 (dansei): man, male
電報 (denpou): telegram
電灯 (dentou): electric light​
どんどん (dondon): rapidly, continuously
泥棒 (dorobou): thief, burglar, robber, theft​
動物園 (doubutsuen): zoo
道具 (dougu): tool, implement
枝 (eda): branch, bough
遠慮 (enryo): constraint, restraint, modesty
選ぶ (erabu): to choose, to select
不便 (fuben): inconvenience
増える (fueru): to increase, to multiply
深い (fukai): deep, profound
復習 (fukushuu): review, revision
複雑 (fukuzatsu): complex, complicated
踏む (fumu): to step on, to tread on​
船 (fune): ship, boat
布団 (futon): futon
太る (futoru): to grow fat
普通 (futsuu): general, ordinary, usual​
頑張る (ganbaru): to hang on, to do one’s best
原因 (gen’in): cause, origin, source​
下宿 (geshuku): boarding, lodging
技術 (gijutsu): technology, engineering​
ご馳走 (gochisou): feast, treating (someone)​
塵 (gomi): rubbish, trash, garbage
ご覧になる (goran ni naru): to see, to look, to watch​
ご存じ (gozonji): knowing
ご主人 (goshujin): your husband
具合 (guai): condition, state, health
軍人 (gunjin): military personnel, soldier
葉 (ha): leaf
拝見 (haiken): seeing, look at
歯医者 (haisha): dentist
始める (hajimeru): to start, to begin
はっきり (hakkiri): clearly, plainly
運ぶ (hakobu): to carry, to transport
花見 (hanami): cherry blossom viewing
反対 (hantai): opposition, resistance
払う (harau): to pay
発音 (hatsuon): pronunciation
林 (hayashi): woods, forest
恥ずかしい (hazukashii): shy, embarrassed
変 (hen): strange, odd, peculiar
返事 (henji): reply, answer, response​
酷い (hidoi): cruel, heartless
冷える (hieru): to grow cold
ひげ (hige): mustache, beard
非常に (hijou ni): very, extremely
光 (hikari): light, beam
光る (hikaru): to shine, to glitter
引き出し (hikidashi): drawer
引き出す (hikidasu): to pull out, to take out
引っ越す (hikkosu): to move (house)
飛行場 (hikoujou): airfield, airport
開く (hiraku): to open, to undo​
昼間 (hiruma): daytime, during the day
拾う (hirou): to pick up
昼休み (hiruyasumi): lunch break
久しぶり (hisashiburi): it’s been a while
褒める (homeru): to praise, to admire
翻訳 (honyaku): translation
星 (hoshi): star
ほとんど (hotondo): mostly, nearly
法律 (houritsu): law
一度 (ichido): once, one time
医学 (igaku): medical science, medicine
苛める (ijimeru): to bully, to torment
以上 (ijou): not less than, beyond
以下 (ika): not exceeding, below
意見 (iken): opinion, view, comment​
生きる (ikiru): to live, to exist​
以内 (inai): within, inside of
田舎 (inaka): rural area, countryside
祈る (inoru): to pray, to wish​
一杯 (ippai): full, a lot
石 (ishi): stone, gem, jewel
一生懸命 (isshoukenmei): very hard, with utmost effort
急ぐ (isogu): to hurry, to rush
糸 (ito): thread, yarn, string
邪魔 (jama): hindrance, obstacle
字 (ji): character (i.e. kanji)​
時代 (jidai): period, epoch, era, age​
事故 (jiko): accident, incident, trouble​
事務所 (jimusho): office
神社 (jinja): Shinto shrine​
人口 (jinkou): population
地震 (jishin): earthquake
辞典 (jiten): dictionary
自由 (jiyuu): freedom, liberty
女性 (josei): woman, female
準備 (junbi): preparation, set up
十分 (juubun): plenty, enough, sufficient
住所 (juusho): address
壁 (kabe): wall, partition​
課長 (kachou): section manager, section chief​
帰り (kaeri): return, coming back​
変える (kaeru): to change, to alter
科学 (kagaku): science
鏡 (kagami): mirror, looking-glass​
海岸 (kaigan): coast, beach​
会議 (kaigi): meeting, conference
会議室 (kaigishitsu): conference room
会場 (kaijou): assembly hall, meeting place
会話 (kaiwa): conversation
火事 (kaji): fire, conflagration​
掛ける (kakeru): to hang, to hoist, to raise
格好 (kakkou): shape, form, figure
構う (kamau): to mind, to care about
髪 (kami): hair (on the head)​
噛む (kamu): to bite, to chew, to gnaw​
家内 (kanai): (my) wife
必ず (kanarazu): always, without exception
悲しい (kanashii): sad, sorrowful​
金持ち (kanemochi): rich person​
考える (kangaeru): to think about
関係 (kankei): relation, relationship, connection
彼女 (kanojo): she, her
簡単 (kantan): simple, easy, uncomplicated​
顔 (kao): face, look
彼 (kare): he, him
彼ら (karera): they, them
形 (katachi): form, shape, figure
硬い (katai): hard, solid, tough​
片付ける (katazukeru): to tidy up, to put in order
勝つ (katsu): to win, to gain victory​
乾く (kawaku): to get dry
代わり (kawari): substitute, replacement
変わる (kawaru): to change, to be transformed
通う (kayou): to go back and forth between
飾る (kazaru): to decorate, to ornament
毛 (ke): hair, fur, wool​
怪我 (kega): injury, hurt
計画 (keikaku): plan, project
経験 (keiken): experience
警察 (keisatsu): police
経済 (keizai): economics, economy
見物 (kenbutsu): sightseeing, watching
喧嘩 (kenka): quarrel, brawl, fight
研究 (kenkyuu): study, research, investigation​
研究室 (kenkyuushitsu): laboratory
消しゴム (keshogomu): eraser
景色 (keshiki): scenery, landscape​
気 (ki): spirit, mind, heart​
厳しい (kibishii): severe, strict, rigid
気分 (kibun): feeling, mood
機会 (kikai): chance, opportunity​
危険 (kiken): danger, peril, hazard​
聞こえる (kikoeru): to be heard, to be audible​
決る (kimaru): to be decided, to be settled​
決める (kimeru): to decide, to choose
君 (kimi): you, buddy, pal
気持ち (kimochi): feeling, sensation, mood​
近所 (kinjo): neighborhood
季節 (kisetsu): season
汽車 (kisha): train
規則 (kisoku): rule, regulation​
きっと: surely, undoubtedly
心 (kokoro): mind, heart, spirit​
国内 (kokunai): internal, domestic​
国際 (kokusai): international
細かい (komakai): small, fine, minute
米 (kome): rice
込む (komu): to be crowded, to be packed​
今度 (kondo): this time, next time
この間 (kono aida): the other day, lately
この頃 (kono goro): recently, nowadays
今夜 (kon’ya): this evening, tonight​
これから (kore kara): after this
故障 (koshou): breakdown, out of order
答え (kotae): answer, reply, response
事 (koto): thing, matter
小鳥 (kotori): small bird, songbird​
校長 (kouchou): principal, headmaster​
講堂 (koudou): auditorium, lecture hall​
郊外 (kougai): suburb, outskirts​
講義 (kougi): lecture
工業 (kougyou): (manufacturing) industry​
工場 (koujou): factory, plant, mill
高校 (koukou): senior high school, high school​
高校生 (koukousei): senior high school student​
公務員 (koumuin): government worker, public servant
交通 (koutsuu): traffic, transportation
壊れる (kowareru): to be broken
壊す (kowasu): to break, to destroy
首 (kubi): neck
雲 (kumo): cloud
比べる (kuraberu): to compare
暮れる (kureru): to get dark, to grow dark​
草 (kusa): grass, weed, herb
空気 (kuuki): air, atmosphere​
空港 (kuukou): airport
怖い (kowai): scary, frightening
客 (kyaku): guest, visitor​
教育 (kyouiku): education, schooling
教会 (kyoukai): church
興味 (kyoumi): interest, curiosity
競争 (kyousou): competition, contest
急 (kyuu): sudden, abrupt, unexpected​
急行 (kyuukou): moving at high speed​
間違える (machigaeru): to make a mistake
参る (mairu): to go, to come (humble)
真面目 (majime): seriousness, earnestness
負ける (makeru): to lose, to be defeated
漫画 (manga): cartoon, comic
間に合う (maniau): to be in time for
真中 (mannaka): middle, center
または (matawa): or, otherwise
周り (mawari): surroundings, neighbourhood
回る (mawaru): to turn, to revolve
まず (mazu): first of all
召し上がる (meshiagaru): to eat, to drink
珍しい (mezurashii): unusual, rare, curious​
見える (mieru): to be seen, to be in sight
港 (minato): harbor, port
見つかる (mitsukaru): to be found
見つける (mitsukeru): to discover, to find
Advertisement
湖 (mizuumi): lake
もちろん (mochiron): of course, certainly
戻る (modoru): to return, to go back
森 (mori): forest
もし (moshi): if, in case
申し上げる (moushiageru): to say, to tell (humble)
申す (mousu): to say, to be called (humble)
もうすぐ (mousugu): soon, shortly
迎える (mukaeru): to go out to meet
向かう (mukau): to face, to go towards
昔 (mukashi): olden days, former
無理 (muri): unreasonable, impossible
虫 (mushi): insect, bug
息子 (musuko): son
娘 (musume): (my) daughter, girl
投げる (nageru): to throw, to cast away
中々 (nakanaka): very, considerably
泣く (naku): to cry, to weep
無くなる (nakunaru): to be lost, to be missing
亡くなる (nakunaru): to die
治る (naoru): to be cured
直る (naoru): to get mended
直す (naosu): to fix, to repair
慣れる (nareru): to get used to
鳴る (naru): to sound, to ring
なるほど (naru hodo): I see!, That’s right!
寝坊 (nebou): sleeping in late
値段 (nedan): price, cost
眠い (nemui): sleepy, drowsy
眠る (nemuru): to sleep
熱心 (nesshin): zeal, enthusiasm
熱 (netsu): heat
苦い (nigai): bitter
逃げる (nigeru): to escape, to run away
二階建て (nikaidate): two-storied building​
日記 (nikki): diary, journal
人形 (ningyou): doll
匂い (nioi): scent, smell
似る (niru): to resemble, to look like
喉 (nodo): throat
残る (nokoru): to remain, to be left
乗り換える (norikaeru): to transfer (trains), to change (bus, train)​
乗り物 (norimono): vehicle, conveyance
濡れる (nureru): to get wet
塗る (nuru): to paint, to plaster
盗む (nusumu): to steal​
入学 (nyuugaku): entry to school or university
入院 (nyuuin): hospitalization
落ちる (ochiru): to fall down, to drop
踊り (odori): dance
驚く (odoroku): to be surprised, to be astonished​
踊る (odoru): to dance
お祝い (oiwai): congratulations, celebration
お嬢さん (ojousan): (your) daughter, young lady
可笑しい (okashii): funny, strange, odd
行う (okonau): to perform, to do
怒る (okoru): to get angry, to get mad​
起こす (okosu): to raise, to wake, to cause
億 (oku): hundred million
屋上 (okujou): rooftop
贈り物 (okurimono): present, gift
遅れる (okureru): to be late, to be delayed
送る (okuru): to send, to dispatch
お祭り (omatsuri): festival, feast, carnival​
お見舞い (omimai): calling on someone who is ill
お土産 (omiyage): present, souvenir​
玩具 (omocha): toy, plaything
思い出す (omoidasu): to recall, to remember
表 (omote): surface, face, front, outside
思う (omou): to think, to consider
お礼 (orei): thanks, gratitude
折れる (oreru): to break, to be broken
折る (oru): to break, to fracture
押し入れ (oshiire): closet
仰る (ossharu): to say, to speak
お宅 (otaku): your house, your home, your family
音 (oto): sound, noise
落とす (otosu): to drop, to let fall
夫 (otto): husband
お釣り (otsuri): change (for a purchase)
終わり (owari): the end
親 (oya): parent, parents
歴史 (rekishi): history
連絡 (renraku): to contact, to get in touch​
利用 (riyou): use, utilization
理由 (riyuu): reason, motive
留守 (rusu): absence, being away from home​
旅館 (ryokan): Japanese-style lodging
両方 (ryouhou): both, both sides
寂しい (sabishii): lonely, lonesome, solitary
下がる (sagaru): to come down, to get lower
探す (sagasu): to search, to look for
下げる (sageru): to hang, to lower
最後 (saigo): last, final, latest
最近 (saikin): most recent, these days
最初 (saisho): beginning, first
坂 (saka): slope, hill
盛ん (sakan): popular, prosperous
さっき (sakki): some time ago, just now
昨夜 (sakuya): last night
産業 (sangyou): industry
さ来月 (saraigetsu): month after next​
さ来週 (saraishuu): week after next​
差し上げる (sashiageru): to give, to offer
騒ぐ (sawagu): to make noise, to rustle
触る (sawaru): to touch, to feel​
政治 (seiji): politics, government​
生活 (seikatsu): living, life
生産 (seisan): production, manufacture
西洋 (seiyou): the west, Western countries​
世界 (sekai): the world, society
席 (seki): seat
線 (sen): line, stripe, stria​
背中 (senaka): back (of body)​
先輩 (senpai): senior (at work or school)
戦争 (sensou): war
説明 (setsumei): explanation, exposition​
世話 (sewa): looking after, help
社長 (shachou): company president
社会 (shakai): society, public, community
市 (shi): city
試合 (shiai): match, game
しばらく: little while, short while
叱る (shikaru): to scold
仕方 (shikata): way, method, means
試験 (shiken): examination, exam, test​
しっかり: tightly, firmly, securely
島 (shima): island
市民 (shimin): citizen, citizenry, public​
品物 (shinamono): goods, article, thing​
新聞社 (shinbunsha): newspaper company
心配 (shinpai): worry, concern, anxiety
親切 (shinsetsu): kindness, gentleness​
調べる (shiraberu): to examine, to investigate
知らせる (shiraseru): to notify, to advise, to inform​
下着 (shitagi): underwear
支度 (shitaku): preparation, arrangements​
失礼 (shitsurei): discourtesy, impoliteness​
失敗 (shippai): failure, mistake, blunder​
食事 (shokuji): meal
食料品 (shokuryouhin): foodstuff, groceries​
小学校 (shougakkou): primary school
紹介 (shoukai): introduction, presentation
小説 (shousetsu): novel, (short) story​
将来 (shourai): future, prospects
招待 (shoutai): invitation
趣味 (shumi): hobby, pastime
出発 (shuppatsu): departure
出席 (shusseki): attendance, presence
習慣 (shuukan): habit, custom
祖母 (sobo): grandmother
育てる (sodateru): to raise, to rear, to bring up
祖父 (sofu): grandfather
そんな (sonna): such
それで (sore de): and, thereupon
それほど (sore hodo): to that degree
それに (sore ni): besides, in addition
そろそろ (sorosoro): soon, momentarily
卒業 (sotsugyou): graduation
相談 (soudan): consultation, discussion
素晴らしい (subarashii): wonderful, splendid
滑る (suberu): to glide, to slide
水道 (suidou): water supply, water service
過ぎる (sugiru): to pass through, to pass by
凄い (sugoi): terrible, dreadful​, amazing
水泳 (suiei): swimming
すっかり (sukkari): all, completely, totally
空く (suku): to become empty
隅 (sumi): corner, nook, recess​
済む (sumu): to finish, to end
砂 (suna): sand, grit​
進む (susumu): to advance, to go forward​
捨てる (suteru): to throw away, to cast away
数学 (suugaku): mathematics
正しい (tadashii): right, correct
退院 (taiin): discharge from hospital​
大抵 (taitei): mostly, ordinarily
たまに (tama ni): occasionally, once in a while​
棚 (tana): shelf, shelves
楽しみ (tanoshimi): enjoyment, pleasure
楽む (tanoshimu): to enjoy (oneself)​
倒れる (taoreru): to fall, to collapse
足りる (tariru): to be sufficient, to be enough​
確か (tashika): sure, certain, positive
足す (tasu): to add, to top up
多数 (tasuu): large number, many​
畳 (tatami): tatami mat
立てる (tateru): to stand up
建てる (tateru): to build, to construct​
訪ねる (tazuneru): to visit, to call on
尋ねる (tazuneru): to ask, to enquire
手袋 (tebukuro): glove, mitten, mitt​
丁寧 (teinei): polite, courteous, careful​
適当 (tekitou): suitable, proper, fit
点 (ten): point, dot, spot
天 (ten): sky
店員 (ten’in): shop assistant, clerk
天気予報 (tenkiyohou): weather forecast
展覧会 (tenrankai): exhibition
寺 (tera): temple (Buddhist)​
手伝う (tetsudau): to help, to assist, to aid​
届ける (todokeru): to deliver, to send
床屋 (tokoya): barbershop, barber​
特別 (tokubetsu): special
特に (toku ni): particularly, especially​
特急 (tokkyuu): limited express
泊まる (tomaru): to stay at (e.g. hotel)​
遠く (tooku): far away, distant
通る (tooru): to go by, to go past
取り替える (torikaeru): to exchange, to replace​
とうとう (toutou): finally, at
都合 (tsugou): circumstances, convenience​
捕まえる (tsukamaeru): to catch, to arrest
月 (tsuki): moon
付く (tsuku): to be attached, to adhere
妻 (tsuma): wife
連れる (tsureru): to lead, to take (a person)​
釣る (tsuru): to fish, to lure in
伝える (tsutaeru): to convey, to report
包む (tsutsumu): to wrap up, to tuck in
続ける (tsuzukeru): to continue, to keep up
続く (tsuzuku): to continue, to last, to go on​
腕 (ude): arm
植える (ueru): to plant, to grow, to raise​​
動く (ugoku): to move, to stir, to shift
受ける (ukeru): to receive, to get​
受付 (uketsuke): reception (desk), information desk​
旨い (umai): delicious, appetizing
運動 (undou): exercise, motion
運転 (unten): operation, operating
運転手 (untenshu): driver, chauffeur​
裏 (ura): reverse side, rear, back
嬉しい (ureshii): happy, glad
売り場 (uriba): sales floor, counter (in shop)​
嘘 (uso): lie, falsehood
打つ (utsu): to hit, to strike, to knock
美しい (utsukushii): beautiful, lovely​
移る (utsuru): to move (house), to transfer (department)​
写す (utsusu): to transcribe, to duplicate
別れる (wakareru): to part, to separate
沸かす (wakasu): to boil, to heat​
訳 (wake): reason, cause
沸く (waku): to grow hot, to boil
笑う (warau): to laugh
割れる (wareru): to break, to be smashed
割合 (wariai): rate, ratio
忘れ物 (wasuremono): something forgotten
やはり (yahari): as expected
焼ける (yakeru): to be roasted
焼く (yaku): to burn, to roast, to bake
役に立つ (yaku ni tatsu): to be helpful, to be useful​
約束 (yakusoku): promise, agreement
止める (yameru): to stop
止む (yamu): to cease, to stop
優しい (yasashii): tender, kind, gentle
痩せる (yaseru): to become thin, to slim
やっと (yatto): at last
柔らかい (yawarakai): soft, tender
用 (you): business, task, errand
汚れる (yogoreru): to get dirty
喜ぶ (yorokobu): to be delighted
寄る (yoru): to approach, to drop by
予習 (yoshuu): preparation for a lesson​
予定 (yotei): plans, arrangement
用意 (youi): preparation, arrangements
用事 (youji): tasks, things to do
予約 (yoyaku): reservation, appointment
湯 (yu): hot water
指 (yubi): finger, toe
指輪 (yubiwa): (finger) ring
夢 (yume): dream
輸入 (yunyuu): import, importation
揺れる (yureru): to shake, to sway
輸出 (yushutsu): export
夕食 (yuushoku): evening meal, dinner​
残念 (zannen): deplorable, regret, bad luck
随分 (zuibun): very, extremely, surprisingly
浴びる (abiru): to take a shower
危ない (abunai): dangerous, risky
あげる (ageru): to give
赤/赤い (aka/akai): red
明るい (akarui): bright, colorful
開ける (akeru): to open
秋 (aki): autumn
開く (aku): to open
甘い (amai): sweet
雨 (ame): rain
あなた (anata): you
兄 (ani): older brother
姉 (ane): older sister
青い (aoi): blue
洗う (arau): to wash
有る (aru): to be, to exist
歩く (aruku): to walk
朝 (asa): morning
朝ご飯 (asagohan): breakfast
明後日 (asatte): day after tomorrow
足 (ashi): foot, leg
明日 (ashita): tomorrow
遊ぶ (asobu): to play
あそこ (asoko): there, over there
頭 (atama): head
暖かい (atatakai): warm, mild
新しい (atarashii): new, fresh
後 (ato): behind after, later
暑い (atsui): hot (weather)
熱い (atsui): hot (thing)
厚い (atsui): thick
会う (au): to meet
晩ご飯 (bangohan): dinner
番号 (bangou): number
勉強 (benkyou): study, diligence
便利 (benri): convenient, handy
帽子 (boushi): hat, cap
病院 (byouin): hospital
病気 (byouki): illness, disease
豚肉 (butaniku): pork
茶色 (chairo): light brown
茶碗 (chawan): rice bowl, tea cup
父 (chichi): father
違う (chigau): to differ (from)
小さい (chiisai): small, little, tiny
近い (chikai): near, close
近く (chikaku): near, neighborhood
地下鉄 (chikatetsu): subway, metro
ちょっと (chotto): a little
ちょうど (choudo): exactly, precisely, just
地図 (chizu): map
台所 (daidokoro): kitchen
大学 (daigaku): university
大丈夫 (daijoubu): safe, all right, okay
段々 (dandan): gradually, little by little
誰 (dare): who
誰か (dareka): someone, somebody
出す (dasu): to take out
出口 (deguchi): exit, gateway
出かける (dekakeru): to go out
電気 (denki): electricity, light
電車 (densha): train, electric train
電話 (denwa): telephone call, phone
出る (deru): to leave, to exit
どちら (dochira): which one
どこ (doko): where
どう (dou): how, in what way, how about
動物 (doubutsu): animal
どうも (doumo): thanks
どうして (doushite): why, for what reason
どうぞ (douzo): please, feel free
土曜日 (doyoubi): Saturday
絵 (e): picture, drawing, painting
映画 (eiga): movie, film
映画館 (eigakan): movie theater, cinema
英語 (eigo): English (language)
駅 (eki): station
鉛筆 (enpitsu): pencil
服 (fuku): clothes
吹く (fuku): to blow (wind)
二人 (futari): two people, pair
二日 (futsuka): second day of the month, two days
降る (furu): to fall (rain)
古い (furui): old (not person)
封筒 (fuutou): envelope
冬 (fuyu): winter
学校 (gakkou): school
学生 (gakusei): student
外国 (gaikoku): foreign country
外国人 (gaikokujin): foreigner
元気 (genki): lively, full of spirit
玄関 (genkan): entranceway, entrance hall
月曜日 (getsuyoubi): Monday
銀行 (ginkou): bank
牛肉 (gyuuniku): beef
牛乳 (gyuunyuu): milk
五 (go): five
午後 (gogo): afternoon, p.m.
ご飯 (gohan): cooked rice, meal
午前 (gozen): morning, a.m.
歯 (ha): tooth
八 (hachi): eight
葉書 (hagaki): postcard
母 (haha): mother
入る (hairu): to enter, to go into
灰皿 (haizara): ashtray
始め (hajime): beginning, start
初めて (hajimete): for the first time
始まる (hajimaru): to begin, to start
箱 (hako): box, chest
半分 (hanbun): half
花 (hana): flower, blossom
鼻 (hana): nose
話 (hanashi): talk, speech, chat
話す (hanasu): to talk, to speak
晴れる (hareru): to clear up
春 (haru): spring, springtime
貼る (haru): to stick, to paste
箸 (hashi): chopsticks
橋 (hashi): bridge
走る (hashiru): to run
二十歳 (hatachi): twenty years old
働く (hataraku): to work
二十日 (hatsuka): twentieth day of the month, twenty days
早い (hayai): early
早く (hayaku): early, soon, quickly
速い (hayai): fast, quick
辺 (hen): area, vicinity
下手 (heta): unskillful
部屋 (heya): room, chamber
日 (hi): day, sun
火 (hi): fire, flame
左 (hidari): left, left hand side
東 (higashi): east
弾く (hiku): to play (piano, guitar)
引く (hiku): to pull, to draw
低い (hikui): low (rank), short (height)
飛行機 (hikouki): aeroplane, airplane
暇 (hima): spare time, free time
広い (hiroi): spacious, vast, wide
昼 (hiru): noon, midday
昼ご飯 (hirugohan): lunch, midday meal
人 (hito): person
一人 (hitori): one person, alone
一つ (hitotsu): one
本 (hon): book
本棚 (hondana): bookshelf, bookcase
本当 (hontou): truth, reality
他 (hoka): other, the rest
百 (hyaku): hundred
一 (ichi): one
一番 (ichiban): number one, first, first place
一日 (ichinichi): one day
家 (ie): house, residence
いい (ii): good
否 (iie): no, nay
池 (ike): pond
行く (iku): to go
幾ら (ikura): how much, how many
幾つ (ikutsu): how many, how old
今 (ima): now, the present time
意味 (imi): meaning, significance
妹 (imouto): younger sister
犬 (inu): dog
入れる (ireru): to put in, to let in
入口 (iriguchi): entrance, gate
色 (iro): color, complexion
色々 (iroiro): various
要る (iru): to need, to want
医者 (isha): (medical) doctor, physician
忙しい (isogashii): busy, occupied
一緒 (issho): together
椅子 (isu): chair, stool
痛い (itai): painful, sore
五日 (itsuka): fifth day of the month, five days
いつも (itsumo): always, usually
五つ (itsutsu): five
言う (iu): to say, to utter
嫌 (iya): disagreeable, detestable
字引 (jibiki): dictionary
自分 (jibun): myself, yourself, oneself
自動車 (jidousha): automobile
時間 (jikan): time, hours
辞書 (jisho): dictionary
自転車 (jitensha): bicycle
上手 (jouzu): skill, skillful
授業 (jugyou): lesson, class work
鞄 (kaban): bag
花瓶 (kabin): (flower) vase
角 (kado): corner, edge
帰る (kaeru): to return, to come home
返す (kaesu): to return (something)
鍵 (kagi): key, lock
階段 (kaidan): stairs, stairway
買物 (kaimono): shopping
会社 (kaisha): company, corporation
書く (kaku): to write, to compose
紙 (kami): paper
漢字 (kanji): Chinese characters
体 (karada): body, torso
辛い (karai): spicy, hot
借りる (kariru): to borrow
軽い (karui): light (not heavy)
傘 (kasa): umbrella
貸す (kasu): to lend, to loan
方 (kata): person
家庭 (katei): home, family, household
買う (kau): to buy, to purchase
可愛い (kawaii): cute, adorable
家族 (kazoku): family, members of a family
風 (kaze): wind, breeze
風邪 (kaze): cold, influenza
川 (kawa): river, stream
警官 (keikan): police officer, policeman
結婚 (kekkon): marriage
結構 (kekkou): spenlid, nice, okay
今朝 (kesa): this morning
消す (kesu): to erase, to delete
木 (ki): tree
消える (kieru): to go out, to vanish
黄色い (kiiroi): yellow
昨日 (kinou): yesterday
金曜日 (kin’youbi): Friday
切符 (kippu): ticket
嫌い (kirai): dislike, hate
切る (kiru): to cut
着る (kiru): to wear, to put on
喫茶店 (kissaten): coffee shop
北 (kita): north
汚い (kitanai): dirty, filthy
切手 (kitte): stamp (postage)
九 (kyuu): nine
声 (koe): voice
ここ (koko): here
九日 (kokonoka): ninth day of the month, nine days
困る (komaru): to be troubled, to be worried
今晩 (konban): tonight, this evening
今週 (konshuu): this week
交番 (kouban): police box
紅茶 (koucha): black tea
公園 (kouen): (public) park
子供 (kodomo): child, children
答える (kotaeru): to answer, to reply
言葉 (kotoba): language, dialect
今年 (kotoshi): this year
交差点 (kousaten): crossing, intersection
聞く (kiku): to hear, to listen
奇麗 (kirei): pretty, lovely, beautiful
去年 (kyonen): last year
今日 (kyou): today, this day
兄弟 (kyoudai): siblings, brothers and sisters
教室 (kyoushitsu): classroom, department
口 (kuchi): mouth, opening, hole
果物 (kudamono): fruit
曇り (kumori): cloudiness, cloudy weather
国 (kuni): country, state, region
暗い (kurai): dark, gloomy
黒い (kuroi): black, dark
来る (kuru): to come
車 (kuruma): car, automobile
薬 (kusuri): medicine
靴 (kutsu): shoes, boots
靴下 (kutsushita): socks
町 (machi): town, block
まだ (mada): still, not yet
前 (mae): front, ahead, previous
毎朝 (maiasa): every morning
毎晩 (maiban): every night
毎月 (maitsuki/maigetsu): every month
毎日 (mainichi): every day
毎週 (maishuu): every week
毎年 (maitoshi): every year, yearly
窓 (mado): window
曲がる (magaru): to bend, to curve
万 (man): ten thousand
丸い (marui): round, circular
また (mata): again, also
待つ (matsu): to wait, to look forward to
不味い (mazui): unappetizing, unsavory
目 (me): eye, eyeball
眼鏡 (megane): spectacles, glasses
道 (michi): road, street, way
緑 (midori): green
磨く (migaku): to polish, to shine
右 (migi): right, right hand side
短い (mijikai): short
耳 (mimi): ear
南 (minami): south
皆 (minna): all, everyone
見る (miru): to see, to look, to watch
店 (mise): store, shop
見せる (miseru): to show, to display
水 (mizu): water
門 (mon): gate
問題 (mondai): question, problem
持つ (motsu): to hold (in one’s hands)
木曜日 (mokuyoubi): Thursday
六日 (muika): sixth day of the month, six days
向こう (mukou): opposite side, other side
村 (mura): village
難しい (muzukashii): difficult, hard
長い (nagai): long, lengthy
中 (naka): inside, in, among
鳴く (naku): to sing (bird)
無くす (nakusu): to lose something
名前 (namae): name, full name
何 (nani): what
七日 (nanoka): seventh day of the month, seven days
並ぶ (narabu): to stand in a line
並べる (naraberu): to line up
習う (narau): to be taught, to learn (from a teacher)
なる (naru): to become
夏 (natsu): summer
猫 (neko): cat
寝る (neru): to go to bed
二 (ni): two
日曜日 (nichiyoubi): Sunday
賑やか (nigiyaka): bustling, busy, lively
肉 (niku): flesh, meat
荷物 (nimotsu): luggage, baggage
西 (nishi): west
庭 (niwa): garden, yard
登る (noboru): to ascend, to go up
飲物 (nomimono): drink, beverage
飲む (nomu): to drink, to gulp
乗る (noru): to get on (train, plane, bus, ship)
脱ぐ (nugu): to take off (clothes, shoes)
伯母さん (obasan): aunt
お祖母さん (obaasan): grandmother
お弁当 (obentou): Japanese lunch box
覚える (oboeru): to memorize, to remember
お茶 (ocha): tea
お風呂 (ofuro): bath
美味しい (oishii): delicious, tasty
お母さん (okaasan): mother
お金 (okane): money
お菓子 (okashi): sweets, candy
起きる (okiru): to get up, to rise
置く (oku): to put, to place
奥さん (okusan): wife, your wife, his wife
お巡りさん (omawarisan): police officer
重い (omoi): heavy, weighty
面白い (omoshiroi): interesting, fascinating
お腹 (onaka): stomach
音楽 (ongaku): music
女 (onna): female, woman
同じ (onaji): same, identical
お姉さん (oneesan): elder sister
お兄さん (oniisan): elder brother
女の子 (onna no ko): girl
多い (ooi): many, numerous, a lot
大きい (ookii): big, large, great
大勢 (oozei): many, crowd, great number of people
降りる (oriru): to descend, to get off
お皿 (osara): plate, dish
教える (oshieru): to teach, to instruct
遅い (osoi): slow, late
押す (osu): to push, to press
お手洗い (otearai): toilet, restroom
男 (otoko): man, male
男の子 (otoko no ko): boy
大人 (otona): adult
一昨日 (ototoi): day before yesterday
お父さん (otousan): father, dad
一昨年 (ototoshi): year before last
弟 (otouto): younger brother
終わる (owaru): to finish, to end
泳ぐ (oyogu): to swim
来月 (raigetsu): next month
来年 (rainen): next year
来週 (raishuu): next week
冷蔵庫 (reizouko): refrigerator
練習 (renshuu): practice
六 (roku): six
廊下 (rouka): corridor, hallway
旅行 (ryokou): travel, trip
料理 (ryouri): cooking, cuisine
両親 (ryoushin): parents, both parents
留学生 (ryuugakusei): overseas student
歳 (sai): years old
財布 (saifu): purse, wallet
魚 (sakana): fish
酒 (sake): alcohol, sake
先 (saki): previous, prior, former
咲く (saku): to bloom
作文 (sakubun): writing (an essay), composition
寒い (samui): cold
三 (san): three
散歩 (sanpo): walk, stroll
再来年 (sarainen): year after next
砂糖 (satou): sugar
背 (se): height, stature
背広 (sebiro): business suit
生徒 (seito): pupil
石鹸 (sekken): soap
狭い (semai): narrow, confined
千 (sen): thousand
先月 (sengetsu): last month
先生 (sensei): teacher, master, doctor
先週 (senshuu): last week
洗濯 (sentaku): washing, laundry
四 (shi, yon): four
七 (shichi, nana): seven
写真 (shashin): photograph, photo, picture
仕事 (shigoto): work, job
閉まる (shimaru): to be shut, to close
閉める (shimeru): to close, to shut
締める (shimeru): to tie, to fasten
新聞 (shinbun): newspaper
死ぬ (shinu): to die, to pass away
塩 (shio): salt
白い (shiroi): white
知る (shiru): to be aware of, to know
下 (shita): below, down, under
質問 (shitsumon): question, inquiry
静か (shizuka): quiet, silent
食堂 (shokudou): dining room, dining hall
醤油 (shouyu): soy sauce
宿題 (shukudai): homework
側 (soba): near, close, beside
空 (sora): sky
外 (soto): outside, exterior
掃除 (souji): cleaning, sweeping
すぐ: immediately
水曜日 (suiyoubi): Wednesday
好き (suki): liking, fondness, love
少し (sukoshi): small quantity, little
少ない (sukunai): few, a little
住む (sumu): to live, to reside
する (suru): to do
吸う (suu): to smoke, to breathe in
座る (suwaru): to sit
涼しい (suzushii): cool, refreshing
煙草 (tabako): tabacco, cigarette
食べ物 (tabemono): food
食べる (taberu): to eat
多分 (tabun): perhaps, probably
大変 (taihen): very, greatly, immense
大切 (taisetsu): important, necessary
大使館 (taishikan): embassy
高い (takai): high, tall, expensive
沢山 (takusan): a lot, plenty, many
卵 (tamago): egg, spawn
誕生日 (tanjoubi): birthday
楽しい (tanoshii): enjoyable, fun
頼む (tanomu): to request, to beg, to ask
建物 (tatemono): building
立つ (tatsu): to stand, to rise
手 (te): hand
手紙 (tegami): letter
天気 (tenki): weather
戸 (to): door
飛ぶ (tobu): to fly
友達 (tomodachi): friend, companion
止まる (tomaru): to stop (moving)
隣 (tonari): neighbor, next to
十日 (tooka): tenth day of the month, ten days
鳥 (tori): bird
取る (toru): to take, to pick up
年 (toshi): year, age
図書館 (toshokan): library
時計 (tokei): watch, clock
時々 (tokidoki): sometimes, at times
所 (tokoro): place, spot, scene
遠い (tooi): far, distant
撮る (toru): to take (a photo), to record (a video)
とても (totemo): very, exceedingly
疲れる (tsukareru): to get tired
次 (tsugi): next, following
使う (tsukau): to use, to make use of
一日 (tsuitachi): first day of the month
着く (tsuku): to arrive at, to reach
机 (tsukue): desk
作る (tsukuru): to make, to produce
詰まらない (tsumaranai): dull, uninteresting
冷たい (tsumetai): cold (to the touch)
勤める (tsutomeru): to work (for), to be employed (at)
強い (tsuyoi): strong, powerful
上 (ue): above, up, over
生まれる (umareru): to be born
海 (umi): sea, ocean
売る (uru): to sell
煩い (urusai): noisy, loud
後ろ (ushiro): back, behind, rear
薄い (usui): thin, pale, light
歌 (uta): song
歌う (utau): to sing
上着 (uwagi): coat, jacket
若い (wakai): young, youthful
分かる (wakaru): to understand, to comprehend
悪い (warui): bad, poor, inferior
忘れる (wasureru): to forget
私 (watashi): I, me
渡る (wataru): to cross over
渡す (watasu): to hand over, to hand in
山 (yama): mountain
やる (yaru): to do
野菜 (yasai): vegetable
安い (yasui): cheap, inexpensive
休み (yasumi): rest, recess
休む (yasumu): to be absent, to take a day off
呼ぶ (yobu): to call out, to call
四日 (yokka): fourth day of the month, four days
横 (yoko): horizontal
読む (yomu): to read
夜 (yoru): evening, night
洋服 (youfuku): Western-style clothes
八日 (youka): eight day of the month, eight days
弱い (yowai): weak, frail, delicate
雪 (yuki): snow
ゆっくり (yukkuri): slowly, at ease
郵便局 (yuubinkyoku): post office
有名 (yuumei): famous
雑誌 (zasshi): journal, magazine
全部 (zenbu): all, entire, whole
アパート (apaato): apartment
バス (basu): bus
ベッド (beddo): bed
デパート (depaato): department store
ドア (doa): door (Western style)
エレベータ (erebeeta): elevator
フォーク (fooku): fork
ギター (gitaa): guitar
グラム (guramu): gram
ホテル (hoteru): hotel
カメラ (kamera): camera
キロ (kiro): kilogram
コーヒー (koohii): coffee
コート (kooto): coat
コップ (koppu): glass
クラス (kurasu): class
パーティー (paatii): party
ペン (pen): pen
ペット (petto): pet
ポケット (poketto): pocket
プール (puuru): swimming pool
セーター (seetaa): sweater, jumper
シャワー (shawaa): shower
シャツ (shatsu): shirt
スカート (sukaato): skirt
スポーツ (supootsu): sport
スプーン (supuun): spoon
スリッパ (surippa): slippers
ストーブ (sutoobu): heater, stove
タクシー (takushii): taxi
テーブル (teeburu): table
テープ (teepu): tape
テープレコーダー (teepu rekoodaa): tape recorder
テレビ (terebi): television, TV
テスト (tesuto): test
トイレ (toire): toilet, restroom
ゼロ (zero): zero, naught
ズボン (zubon): trousers, pants